vylovit+4	вытащить+из-под+l
přeskakovat+4	перепрыгивать+через+a
obrátit+s+7	повернуть+к+d
odstoupit+4	отказаться+от+g
prohlásit+4	провозгласить+n
konat+4	совершать+a
odvézt+4	отвезти+в+a
dosáhnout+7	достать+i
jednat+s+7	обращаться+с+i
připravit+o+4	подготовить+к+d
participovat+na+6	участвовать+в+l
naházet+4	набросать+g
tancovat+s+7	танцевать+в+l
vyrobit+7	сделать+в+l
zahrnovat+v+6	включать+в+a
zatáhnout+za+4	потянуть+за+a
chtít+3	хотеть+за+a
dopouštět+na+6	допускать+по+d
převrátit+4	опрокинуть+в+a
třísknout+7	хлопнуть+i
zaplatit+7	заплатить+за+a
hovořit+pro+4	говорить+в+a
přejít+do+2	перейти+на+a
odevzdávat+3	передавать+g
odvézt+na+6	отвезти+на+l
pověsit+4	повесить+a
hromadit+4	накапливать+a
odpálit+4	выпустить+g
vyjít+k+3	выйти+за+a
dávat+do+2	класть+в+a
diskutovat+4	спорить+i
nabrat+3	зачерпнуть+из+g
odkazovat+4	ссылаться+на+a
poznamenat+7	заметить+с+i
zapsat+4	записать+a
vozit+na+4	возить+к+d
odstoupit+3	отойти+к+d
svázat+4	связать+a
vylézat+4	вылезать+a
ověřit+4	проверить+a
prostudovat+4	изучить+a
udávat+4	задавать+a
nakupovat+4	покупать+a
vypálit+7	выстрелить+в+a
vytěžit+4	извлечь+из+g
doprovodit+7	проводить+i
dojít+2	произойти+в+l
vystavět+na+6	построить+на+l
přemýšlet+nad+7	размышлять+над+i
upravovat+7	поправлять+i
pustit+2	выпустить+из+g
dokončovat+4	завершать+a
ochránit+4	защитить+g
jíst+2	есть+из+g
strkat+4	совать+a
sáhnout+k+3	прибегнуть+к+d
obtěžovat+s+7	приставать+ко+d
dělat+3	готовить+на+a
vysílat+4	посылать+a
ponořit+do+2	погрузить+во+a
náležet+do+2	относиться+к+d
skrývat+4	скрывать+a
uskutečnit+4	провести+a
znamenat+3	означать+g
sklouznout+3	соскользнуть+по+d
shánět+po+6	искать+в+l
bít+7	бить+i
mluvit+k+3	говорить+с+i
vypálit+z+2	выжечь+из+g
kroužit+4	вращать+вокруг+g
uvěřit+v+4	поверить+в+a
plnit+4	выполнять+a
ochutnat+4	попробовать+a
ztotožňovat+s+7	отождествлять+с+i
pálit+4	жечь+n
srážet+3	сбивать+с+g
hlásit+k+3	заявлять+о+l
odpadnout+od+2	отпасть+от+g
odevzdat+3	отдать+d
namítat+proti+3	возражать+против+g
pít+na+4	пить+за+a
spojovat+7	связывать+с+i
mluvit+na+4	говорить+в+a
nastavovat+4	подставлять+a
dojednat+4	согласовать+n
volat+po+6	призывать+к+d
věštit+4	предвещать+a
vyvěšovat+4	вывешивать+a
krást+4	красть+n
odnášet+7	нести+в+l
zajít+7	зайти+к+d
narůst+do+2	вырасти+до+l
mít+za+4	считать+за+a
platit+7	платить+i
aplikovat+na+4	применять+на+a
budovat+4	строить+a
vyskočit+z+2	выскочить+из+g
provést+3	провести+в+l
vyjíždět+na+4	выходить+на+a
objímat+4	обнимать+a
utrácet+7	тратить+на+a
pouštět+z+2	выпускать+из+g
přepínat+4	переключать+a
povzdechnout+7	вздохнуть+за+i
koordinovat+4	координировать+a
dovézt+4	довезти+до+g
odpustit+3	простить+d
ovlivnit+7	повлиять+на+a
hnát+na+4	бежать+по+d
vykořenit+4	выкорчевать+g
pozdravit+7	поздороваться+с+i
ocenit+4	оценить+a
dožít+4	дожить+до+g
přecenit+4	переоценить+a
potlačovat+4	подавлять+a
máchat+7	махать+i
mluvit+o+6	говорить+о+l
přesunout+do+2	переместить+в+a
sbírat+4	собирать+a
požadovat+po+6	требовать+для+g
rozbít+7	разбить+i
převládat+v+6	преобладать+в+l
hodit+na+4	бросить+на+a
pomoci+7	помочь+в+l
přestavovat+4	перестраивать+n
ohromit+4	поразить+a
čekat+s+7	ждать+от+g
poznat+od+2	познать+со+i
připravovat+4	готовить+a
přestupovat+z+2	переходить+в+a
splývat+do+2	сливаться+в+a
zastřelit+7	застрелить+из+g
odrážet+7	отражать+n
míjet+4	проходить+мимо+g
vynechat+z+2	пропустить+из+g
říci+4	сказать+a
mít+na+4	иметь+на+a
zmrzačit+4	изувечить+a
třít+4	тереть+a
vyhubit+4	искоренить+a
předstihnout+7	опередить+в+l
promlouvat+z+2	выступать+перед+i
posuzovat+4	судить+о+l
opřít+7	упереть+в+a
přemluvit+4	уговорить+g
zachránit+před+7	спасти+от+g
vydělávat+7	зарабатывать+на+a
hladit+4	гладить+a
znásobit+4	увеличить+a
klesnout+o+4	упасть+на+l
soustředit+4	сосредоточить+на+l
shrnout+do+2	свести+в+a
vyskočit+k+3	выскочить+из+g
navléknout+4	надеть+на+a
jít+4	касаться+g
napadnout+2	напасть+на+a
nakrájet+4	нарезать+в+a
vytahovat+7	извлекать+из+g
uvádět+7	приводить+в+a
podkopávat+4	подрывать+a
postavit+na+4	поставить+на+a
odletět+v+6	улететь+в+l
vyřadit+z+2	исключить+из+g
kroutit+7	крутить+i
udělit+4	дать+a
spustit+4	опустить+a
požírat+4	пожирать+a
podat+4	подать+a
vystřelit+z+2	выстрелить+из+g
pomýšlet+na+4	подумывать+об+l
vydělat+na+4	заработать+на+a
držet+4	держать+a
přejít+od+2	перейти+от+g
klesat+7	снижаться+в+l
myslet+na+4	думать+о+l
rvát+4	рвать+на+l
přepadat+4	нападать+на+a
přísahat+na+4	клясться+из-за+g
umět+4	уметь+g
potvrdit+4	подтвердить+a
přebírat+v+6	перебирать+в+l
vyjíždět+k+3	выезжать+со+i
dopřát+2	дать+a
běhat+k+3	бегать+к+d
potlačit+4	подавить+a
sjednotit+4	объединить+g
zradit+4	предать+g
překládat+z+2	переводить+из+g
zahynout+na+4	погибнуть+около+g
vylétnout+3	вылететь+из+g
srazit+3	сбить+с+g
namítat+3	возражать+против+g
odvádět+4	отвлекать+от+g
ztlumit+4	понизить+a
půjčovat+4	одалживать+a
počkat+na+4	подождать+на+l
věřit+v+4	верить+в+a
zajímat+4	интересовать+n
dělat+4	делать+a
vyložit+4	изложить+a
vyjmenovat+4	назвать+g
zasednout+4	сесть+a
tolerovat+4	терпеть+n
zatřást+7	потрясти+перед+i
přecházet+4	переходить+в+a
třídit+4	разбирать+a
začít+7	начать+с+g
dokončit+4	завершить+a
otáčet+7	поворачивать+a
vytisknout+4	напечатать+a
zavírat+na+4	запирать+на+a
umírat+na+4	умирать+от+g
vyžadovat+4	требовать+g
dorážet+na+4	нападать+на+a
vypátrat+4	обнаружить+a
jezdit+7	ездить+i
pamatovat+4	помнить+a
mít+nad+7	владеть+в+n
narazit+na+4	наткнуться+на+a
promluvit+na+4	заговорить+со+i
uvěřit+3	поверить+d
likvidovat+4	ликвидировать+a
založit+4	основать+на+l
potřást+4	потрясти+перед+i
prokázat+3	доказать+a
zasvětit+do+2	посвятить+в+a
zastavit+nad+7	остановиться+у+g
pojistit+4	застраховать+от+g
přenést+4	перенести+a
připravit+3	приготовить+n
dostávat+za+4	получать+за+a
žvýkat+4	жевать+a
padat+7	падать+на+a
podcenit+4	недооценить+a
zaútočit+na+4	напасть+на+a
cítit+na+4	чувствовать+на+l
nechat+z+2	забыть+про+a
připevnit+4	прикрепить+к+d
překládat+do+2	переводить+на+n
připravit+4	подготовить+a
dostat+za+4	получить+за+a
sevřít+7	сжать+a
zahrnout+v+6	включить+в+l
stáhnout+4	снять+с+g
bušit+7	стучать+i
odradit+7	отбить+у+g
přijíždět+k+3	подъезжать+к+d
předělat+4	переделать+a
vyrovnávat+4	уравновешивать+a
vyznávat+4	исповедовать+a
vyžadovat+na+6	требовать+от+g
riskovat+4	рисковать+i
přesvědčit+7	убедить+i
vozit+k+3	возить+к+d
vyletět+4	взлететь+в+a
zaujmout+4	занять+a
nastoupit+k+3	отправиться+в+a
odvést+4	отвести+в+a
vzrůst+3	увеличиться+на+l
nastrčit+4	подставить+a
stoupat+3	подниматься+к+d
transformovat+v+4	преобразовать+в+a
zasahovat+4	затрагивать+g
svazovat+4	связывать+a
rozdat+4	раздать+a
zarazit+4	остановить+a
svítit+7	сиять+из-под+g
zaslechnout+o+6	услышать+о+l
oběsit+4	повесить+g
pohrozit+7	погрозить+i
sklízet+7	убирать+со+g
překládat+4	перекладывать+a
pravit+3	сказать+d
probírat+s+7	разбирать+с+i
zobrazit+4	изобразить+g
zahrát+s+7	сыграть+на+l
zajistit+4	обеспечить+a
plést+4	путать+a
pomlouvat+4	клеветать+на+a
plakat+nad+7	плакать+по+d
vysypat+z+2	высыпать+из+g
dokázat+3	доказать+d
zanechávat+2	оставлять+у+g
vláčet+7	волочить+за+i
zpečetit+4	скрепить+a
vjet+3	въехать+в+a
srazit+4	подбить+a
přeložit+do+2	перевести+на+a
chránit+7	защищать+от+g
porazit+7	победить+по+d
inspirovat+4	вдохновить+a
brát+7	брать+i
zaslechnout+z+2	услышать+от+g
ohlašovat+4	сообщать+о+l
povídat+4	говорить+об+l
napustit+4	наполнить+a
vynikat+7	выделяться+g
vycházet+4	выходить+за+a
darovat+na+4	пожертвовать+на+a
vystřídat+4	заменить+в+l
vystavovat+3	подвергать+g
poznamenat+4	заметить+g
hrát+3	играть+на+a
projevovat+7	проявлять+в+l
mířit+4	направлять+на+a
přijít+na+4	прийти+на+a
postavit+z+2	построить+из+g
obchodovat+4	торговать+без+g
vyjádřit+7	выразить+i
usmrtit+4	убить+n
zastupovat+4	представлять+a
podněcovat+4	поощрять+a
preferovat+4	предпочитать+n
vzít+na+4	взять+на+a
zakázat+4	запретить+a
žrát+4	жрать+a
nenávidět+4	ненавидеть+a
obdržet+za+4	получить+за+a
nakrájet+do+2	нарезать+в+a
optimalizovat+4	оптимизировать+для+g
odstřelit+4	расстрелять+a
určovat+4	определять+a
přitisknout+k+3	прижать+к+d
jet+4	поехать+на+a
využít+k+3	использовать+для+g
zastavovat+před+7	останавливаться+перед+i
hřát+4	греть+a
izolovat+od+2	изолировать+от+g
opustit+4	покинуть+a
vyplývat+z+2	вытекать+из+g
velet+4	командовать+i
oplývat+7	изобиловать+i
obhájit+4	защитить+a
vystřízlivět+z+2	протрезветь+после+g
zapadat+7	садиться+за+n
počínat+4	начинать+с+g
pozastavit+4	приостановить+a
přecházet+z+2	переходить+из-под+g
poručit+4	велеть+a
reagovat+na+4	реагировать+на+a
uzavřít+s+7	заключить+с+i
vynaložit+za+4	потратить+около+l
přecházet+v+4	переходить+в+a
zahnout+4	свернуть+на+a
nahrávat+4	записывать+n
zasunout+4	задвинуть+за+i
naplnit+7	наполнить+i
vládnout+7	царить+над+i
provozovat+4	заниматься+i
zanedbat+4	пренебречь+g
shánět+4	искать+g
protestovat+proti+3	протестовать+против+g
skákat+po+6	скакать+на+l
zablokovat+4	заблокировать+a
hnát+s+7	бежать+на+a
uzavřít+7	закрыть+i
zvedat+4	поднимать+a
stanovit+7	установить+с+i
otvírat+7	открывать+i
exportovat+4	экспортировать+n
odtrhnout+od+2	оторвать+от+g
napsat+7	написать+на+l
roztrhávat+4	разрывать+в+a
pochválit+za+4	похвалить+за+a
pomyslet+4	подумать+о+l
patřit+k+3	принадлежать+к+d
kývnout+3	кивнуть+на+a
najímat+na+4	нанимать+для+g
odhadnout+4	оценить+a
dbát+na+4	следить+за+i
uslyšet+od+2	услыхать+от+g
přijmout+od+2	принять+от+g
zmrazit+na+4	заморозить+в+l
odeslat+k+3	отправить+для+g
jít+3	пойти+к+d
usnadnit+4	облегчить+a
trápit+4	мучить+n
povzbuzovat+4	поощрять+g
varovat+4	предостеречь+g
dostat+4	получить+a
pečovat+o+4	ухаживать+за+i
hodnotit+4	оценивать+a
přešlapovat+4	топтаться+у+g
pravit+o+6	говорить+о+a
klást+4	класть+a
mávat+7	размахивать+i
myslet+o+6	думать+о+l
hasit+4	тушить+g
nařídit+3	приказать+d
hnout+7	двинуть+ради+g
utírat+7	вытирать+i
telefonovat+4	звонить+из+g
proniknout+4	проникнуть+через+a
koukat+z+2	глядеть+в+a
založit+na+6	основать+на+l
získávat+z+2	получать+от+g
krmit+4	кормить+g
ukázat+3	показать+d
tahat+z+2	тянуть+в+a
natahovat+na+4	вытягивать+на+l
udivovat+4	поражать+i
ztrácet+na+6	терять+на+l
hovořit+na+4	говорить+о+l
interpretovat+4	толковать+a
nadiktovat+4	продиктовать+a
dojet+k+3	съездить+на+a
pozvedat+4	поднимать+g
zahrát+3	сыграть+d
prohrát+v+6	проиграть+на+l
zvykat+na+4	привыкать+ко+d
myslet+3	думать+о+l
připisovat+3	приписывать+d
nabírat+7	набирать+при+l
sejít+k+3	спуститься+к+d
vynést+4	вынести+a
vyzývat+4	призывать+g
dostat+od+2	получить+от+g
přitáhnout+k+3	притянуть+к+d
přepojit+4	переключить+a
řešit+4	решать+a
proudit+4	течь+по+d
přirovnat+k+3	сравнить+с+i
stáhnout+na+4	содрать+через+a
jet+po+6	ехать+по+d
přeložit+z+2	перевести+с+g
následovat+4	следовать+за+i
zůstávat+7	оставаться+i
porovnat+4	сравнить+a
respektovat+4	уважать+a
zajíždět+7	въезжать+l
ilustrovat+4	иллюстрировать+a
zůstat+7	остаться+i
zdobit+7	украшать+i
odkrývat+4	обнажать+a
přejet+4	проехать+a
léčit+na+4	лечить+в+l
zmáčknout+4	нажать+на+a
zůstat+3	остаться+в+l
sedat+na+4	садиться+на+a
zaklepat+3	постучать+в+a
měnit+v+4	превращать+в+a
zachraňovat+před+7	спасать+от+g
vyvádět+s+7	выводить+на+a
nalézt+v+6	найти+в+l
naložit+3	погрузить+в+a
učit+4	преподавать+n
pohlížet+na+4	смотреть+на+a
šokovat+7	шокировать+g
myslit+3	думать+о+l
obchodovat+s+7	торговать+на+l
záviset+od+2	зависеть+от+g
poukazovat+3	указывать+на+a
uhýbat+7	уклоняться+в+a
čerpat+4	черпать+n
zapadat+do+2	проваливаться+по+a
koupit+3	купить+для+g
vytušit+4	почуять+a
přestát+4	выдержать+n
panovat+v+6	господствовать+в+l
oceňovat+4	оценивать+a
zajet+7	съездить+к+d
povídat+3	говорить+об+l
zatajit+4	затаить+a
dohrát+4	доиграть+a
uříznout+4	отрезать+a
nést+na+4	нести+на+a
vyslat+k+3	послать+к+d
uhodnout+4	отгадать+g
upevnit+4	укрепить+a
konstruovat+4	конструировать+a
líčit+4	описывать+n
naznačit+4	указать+на+n
opřít+4	прислонить+к+d
zakládat+4	создавать+a
popadnout+za+4	схватить+за+a
uzavírat+7	заключать+с+i
nalézt+4	найти+a
obrátit+v+4	обратить+в+a
podnikat+4	предпринимать+a
stimulovat+4	стимулировать+a
vrátit+3	вернуть+d
přijít+4	прийти+a
zaskočit+7	забежать+с+i
vzrůst+z+2	возрасти+с+g
získávat+7	получать+путем+g
zvolit+3	избрать+для+g
vychovávat+k+3	воспитывать+во+l
rozvázat+4	развязать+a
ustupovat+3	отступать+к+d
odrazovat+7	отпугивать+i
propít+4	пропить+за+a
zničit+7	уничтожить+g
překazit+4	помешать+в+l
navázat+4	установить+с+i
vařit+4	варить+a
nadělat+4	наделать+a
mučit+7	морить+i
přepracovat+4	переписать+a
zazpívat+4	спеть+a
dosadit+4	назначить+на+l
přivolávat+4	манить+в+a
zapomenout+na+4	позабыть+о+l
sdělit+o+6	сообщить+о+l
ujistit+4	заверить+g
přitahovat+k+3	притягивать+к+d
svést+na+4	свести+к+l
odvádět+za+4	уводить+с+i
sestoupit+z+2	спуститься+с+g
rozehnat+4	разогнать+n
práskat+7	хлопать+g
vytahovat+4	вытаскивать+из+g
přivádět+4	приводить+ко+d
zaplavit+4	затопить+a
unavit+7	устать+от+g
pouštět+do+2	выпускать+на+a
spadnout+3	упасть+на+a
onemocnět+7	заболеть+i
házet+7	бросать+a
připsat+4	отнести+на+a
oznámit+7	заявить+о+l
vypovídat+o+6	рассказывать+о+l
vyhlásit+za+4	объявить+о+l
vysvětlovat+4	объяснять+a
postavit+za+4	построить+по+d
spojit+s+7	связать+с+i
identifikovat+4	опознать+a
převzít+od+2	позаимствовать+у+g
označovat+4	отмечать+a
demonstrovat+4	продемонстрировать+a
ukázat+na+4	указать+на+a
vyrazit+4	выбить+a
vyzvědět+od+2	выведать+у+g
najímat+k+3	нанимать+для+g
obtěžovat+7	приставать+ко+d
postupovat+v+6	действовать+в+l
zveličovat+4	преувеличивать+a
udělovat+3	давать+d
dostávat+od+2	получать+от+g
připíchnout+4	приколоть+n
docházet+4	происходить+в+a
vycházet+s+7	выходить+с+i
mačkat+4	жать+на+a
opatrovat+4	ухаживать+за+i
vymezovat+4	определять+a
píchat+7	тыкать+i
stoupnout+o+4	подняться+на+a
zareagovat+7	отреагировать+на+a
zamávat+7	замахать+i
letět+na+4	лететь+на+a
vzrušovat+4	волновать+g
zobrazovat+4	изображать+a
najímat+4	нанимать+g
následovat+za+7	последовать+за+i
prohrát+s+7	проиграть+в+l
dopadat+s+7	падать+на+a
pozorovat+4	наблюдать+за+i
zabalit+do+2	завернуть+в+a
integrovat+4	интегрировать+в+a
ztratit+4	потерять+a
sestavit+4	составить+a
sestupovat+na+4	сходить+на+a
shrnout+4	сгрести+в+n
zbavit+2	лишить+g
ohromovat+7	поражать+i
dorůst+do+2	дорасти+до+g
vztyčit+4	поднять+a
zveřejnit+4	опубликовать+a
zkoušet+s+7	репетировать+с+i
vyřešit+7	решить+за+a
zničit+4	уничтожить+a
uchovat+4	сохранить+a
zvednout+7	поднять+к+d
napravit+7	исправить+путем+g
upadnout+do+2	впасть+в+a
plout+na+6	плыть+по+d
utírat+4	вытирать+a
probudit+4	пробудить+в+l
znemožňovat+4	препятствовать+d
utrhnout+z+2	сорвать+с+g
vědět+o+6	знать+о+l
aktualizovat+4	обновить+a
přiložit+k+3	приставить+ко+d
říkat+o+4	говорить+о+l
pomoci+od+2	помочь+около+n
přísahat+3	клясться+d
osvobozovat+od+2	освобождать+от+g
ohrožovat+7	угрожать+n
zahnout+k+3	свернуть+к+d
domluvit+s+7	договориться+с+i
přejímat+4	принимать+на+a
zachraňovat+4	спасать+a
zbožňovat+4	обожать+a
odvážet+na+4	увозить+за+a
slibovat+za+4	обещать+за+a
diskvalifikovat+4	дисквалифицировать+g
přecházet+k+3	переходить+к+d
zastavovat+7	останавливаться+перед+i
opomíjet+4	игнорировать+g
poslat+3	послать+d
sousedit+s+7	примыкать+к+d
sehrát+v+6	сыграть+в+l
rozmlouvat+7	разговаривать+i
odstranit+4	устранить+a
jet+na+4	поехать+на+a
posadit+4	посадить+a
potrestat+za+4	наказать+в+l
předejít+3	избежать+до+l
odpustit+4	простить+a
vydělávat+4	зарабатывать+на+a
ohodnotit+4	оценить+по+d
kroutit+4	крутить+a
vložit+do+2	вложить+в+a
uškodit+3	навредить+d
uhodit+na+4	накинуться+на+a
redukovat+z+2	приводить+к+d
zasvěcovat+do+2	посвящать+в+l
zkrátit+o+4	сократить+на+a
přikrývat+4	прикрывать+a
vybírat+4	выбирать+a
přikrýt+7	прикрыть+i
poukázat+7	указать+a
udržet+3	сохранить+за+i
pokračovat+7	продолжаться+с+i
zakrývat+4	скрывать+a
sejít+na+4	спуститься+во+a
zavrhovat+4	отвергать+a
okupovat+4	оккупировать+a
ubezpečovat+4	заверять+g
zdvíhat+4	поднимать+g
dělit+s+7	делить+с+i
natáhnout+po+6	протянуть+к+d
absolvovat+4	окончить+g
odjet+4	уехать+на+a
přiběhnout+k+3	подбежать+к+d
poznat+4	узнать+a
přeměnit+v+4	преобразовать+в+a
vjet+na+6	въехать+на+l
přeskakovat+3	перескакивать+с+g
přikázat+4	приказать+a
spouštět+z+2	спускать+с+g
podnítit+4	поощрить+g
cestovat+7	путешествовать+между+i
kapitulovat+před+7	капитулировать+перед+i
zahrát+na+4	сыграть+на+l
zahájit+4	начать+a
dominovat+7	доминировать+на+l
poukazovat+na+4	указывать+на+a
dopravovat+4	доставлять+a
zvětšit+4	увеличить+a
nechat+7	оставить+в+l
sjet+k+3	спуститься+на+l
ustupovat+v+6	отступать+к+d
hradit+4	покрывать+g
nanosit+4	натаскать+g
připadat+do+2	приходиться+около+l
ponechávat+4	оставлять+a
dodržet+4	выполнить+a
spoléhat+na+4	полагаться+на+a
spasit+7	спасти+a
vyvážit+4	сбалансировать+n
upéci+4	испечь+a
vypsat+4	назначить+на+a
stačit+na+4	хватить+на+a
požádat+o+4	попросить+у+g
naplňovat+4	наполнять+a
zvládat+4	справляться+i
uhodit+7	стукнуть+i
nalepovat+na+4	наклеивать+на+a
vzdělávat+4	просвещать+g
přestoupit+do+2	перейти+в+a
prodiskutovat+4	обсудить+с+i
zachovat+v+6	сохранить+в+l
vystřihovat+4	вырезать+из+g
převzít+za+4	принять+на+a
pomáhat+s+7	помогать+в+l
rozšiřovat+4	расширять+a
odrážet+v+6	отражать+на+a
vysvětlovat+3	объяснять+d
diskreditovat+4	дискредитировать+a
jít+na+4	пойти+на+a
cítit+s+7	чувствовать+возле+g
zhodnotit+4	оценить+a
utvořit+4	сформировать+n
aspirovat+na+4	стремиться+к+d
odpovědět+3	ответить+d
trefit+4	попасть+в+a
pohrdnout+7	пренебречь+i
zvítězit+nad+7	победить+в+l
natáhnout+3	протянуть+к+d
odrazit+7	отразить+в+l
distribuovat+mezi+4	распределить+между+i
uvěřit+4	уверовать+во+a
přerůstat+v+4	перерастать+в+a
klesnout+3	опуститься+до+g
použít+4	использовать+a
vrtět+7	вертеть+перед+i
chválit+za+4	хвалить+за+a
uvařit+4	приготовить+a
navštěvovat+4	посещать+a
dbát+o+4	следить+за+i
zastavit+7	остановиться+перед+i
stačit+3	поспеть+за+i
vyzařovat+4	испускать+a
uslyšet+z+2	услыхать+по+d
bušit+4	колотить+a
vařit+3	готовить+g
prosit+4	просить+a
zavolat+3	позвонить+d
předurčit+k+3	предназначить+под+a
devalvovat+4	девальвировать+a
přecházet+7	переключаться+от+g
vyrůstat+z+2	вырастать+из+g
produkovat+4	производить+в+l
otálet+s+7	медлить+с+i
uvádět+do+2	приводить+в+a
zvolit+za+4	избрать+на+a
vynést+na+4	вынести+из-за+g
zlámat+4	сломать+a
vynaložit+4	потратить+на+a
zastavovat+nad+7	останавливаться+над+i
hnát+do+2	мчаться+на+a
zredukovat+7	сократить+с+i
shazovat+4	сбрасывать+с+g
platit+na+4	платить+на+a
poklesnout+na+4	упасть+до+g
přerušit+4	прервать+a
vyvolat+4	вызвать+a
vzrůst+na+4	возрасти+на+l
vléci+k+3	тащить+на+a
zdobit+4	украшать+a
natahovat+k+3	протягивать+к+d
namířit+proti+3	направить+против+g
apelovat+na+4	апеллировать+к+d
bývat+na+6	бывать+в+l
odvézt+3	отвезти+в+a
přebíhat+4	перебегать+с+g
zpomalit+4	замедлить+a
komplikovat+4	усложнять+a
sjet+po+6	съехать+по+d
recitovat+4	декламировать+в+l
ležet+na+6	лежать+на+l
vyčistit+4	вычистить+a
zanechat+3	оставить+d
rozluštit+4	расшифровать+a
opatřit+7	оснастить+i
dráždit+4	раздражать+g
vyzvat+4	призвать+g
diskutovat+o+6	спорить+о+l
rozptýlit+4	развлечь+a
pokračovat+v+6	продолжаться+в+l
vyžadovat+od+2	требовать+от+g
zaujmout+7	увлечь+i
vystřihnout+z+2	вырезать+из+g
stavět+do+2	ставить+в+a
vydělat+4	заработать+a
vytvořit+3	создать+d
zasahovat+7	вмешиваться+в+a
závidět+3	завидовать+d
zaplašit+4	прогнать+a
udržovat+3	сохранять+у+g
vybavit+7	оснастить+i
zabírat+4	занимать+a
vypadat+3	походить+на+a
prohlížet+4	рассматривать+a
vyrovnat+7	выровнять+при+l
zabránit+3	предотвратить+a
zařadit+4	включить+в+a
připoutat+k+3	привязать+к+d
zostřovat+4	обострять+a
nasadit+4	надеть+a
zachvátit+4	затронуть+в+l
přenést+k+3	перенести+к+d
vypudit+4	вытеснить+g
házet+4	бросать+a
říci+3	сказать+d
požívat+2	пользоваться+i
revidovat+4	пересмотреть+a
spoléhat+v+6	полагаться+на+a
vyhlásit+7	объявить+d
praktikovat+4	практиковать+a
prodat+za+4	продать+за+a
volat+4	призывать+к+d
zastavit+u+2	остановиться+у+g
zastírat+4	скрывать+g
vnutit+4	навязать+a
srovnat+7	сровнять+с+i
sebrat+4	взять+a
vybírat+mezi+7	выбирать+между+i
vztahovat+4	протягивать+a
vinit+4	обвинять+в+l
zůstat+u+2	остаться+у+g
sledovat+7	следить+за+i
spustit+3	спустить+на+a
sejít+z+2	сбиться+с+g
navrhovat+4	предлагать+a
procedit+4	процедить+a
spouštět+4	спускать+с+g
toužit+po+6	мечтать+о+l
poučovat+4	поучать+a
míjet+7	проходить+мимо+g
jednat+o+4	говорить+о+l
nastupovat+do+2	садиться+в+a
vrhat+na+4	отбрасывать+на+a
proběhnout+4	пройти+в+l
jezdit+v+6	ездить+в+l
obrátit+4	повернуть+к+d
vyložit+3	пересказать+d
chválit+4	хвалить+за+a
přeskakovat+z+2	перескакивать+с+g
vyplňovat+3	заполнять+a
lepit+4	наклеивать+a
vynaleznout+4	изобрести+a
donutit+4	заставить+a
zatočit+7	повертеть+в+l
ubírat+4	отнимать+a
reagovat+7	отвечать+на+a
požadovat+od+2	требовать+от+g
vložit+3	вложить+в+a
jezdit+na+6	кататься+на+l
inscenovat+4	инсценировать+a
vylézat+na+4	вылезать+из+g
vybrat+mezi+7	выбрать+между+i
představit+3	представить+d
zkreslovat+4	искажать+a
vyhostit+4	выслать+из+g
ochraňovat+před+7	охранять+от+g
prodávat+za+4	продавать+по+d
zachránit+4	спасти+a
uhájit+4	отстоять+a
nasadit+3	надеть+на+a
zaskočit+k+3	забежать+с+i
upravovat+3	приспосабливать+к+d
schovávat+4	прятать+под+a
vyšplhat+na+4	залезть+на+a
zadržovat+4	задерживать+a
hýčkat+4	баловать+g
dostat+z+2	вытащить+из+g
odstoupit+z+2	отказаться+от+g
padat+z+2	падать+на+a
žádat+4	требовать+g
pohltit+4	поглотить+a
garantovat+4	гарантировать+a
zamknout+4	запереть+a
pět+3	пять+d
uvažovat+4	думать+о+l
upozornit+na+4	указать+на+a
zapíchnout+4	воткнуть+a
škrábat+4	чистить+a
proniknout+7	проникнуть+сквозь+a
ochránit+proti+3	защитить+от+g
vyrůst+do+2	вырасти+в+l
zranit+7	ранить+i
postavit+proti+3	поставить+под+a
usuzovat+o+6	судить+по+d
zahrnovat+7	включать+в+a
popadnout+4	схватить+a
zastínit+4	заслонить+a
zavřít+4	закрыть+a
utěšovat+4	утешать+a
poškrábat+4	почесать+a
dát+na+4	поставить+перед+i
děkovat+za+4	благодарить+за+a
zvonit+na+4	звонить+в+a
mít+s+7	иметь+к+d
odtrhnout+4	оторвать+a
slíbit+3	обещать+d
upozorňovat+na+4	указывать+на+a
střídat+4	чередовать+i
připomínat+3	напоминать+d
stačit+4	успеть+a
odklidit+4	убрать+a
zapadnout+7	занести+i
svolat+4	собрать+a
myslit+na+4	думать+о+l
využívat+4	использовать+a
oddělovat+od+2	отделять+от+g
svázat+s+7	связать+с+i
vytrhávat+z+2	вырывать+из+g
vodit+4	водить+за+i
napomoci+3	помочь+d
odvést+za+4	отвести+к+d
vyjít+3	выйти+на+a
přepravovat+4	транспортировать+за+a
zlepšit+4	улучшить+a
odtahovat+4	отодвигать+a
vyvést+na+4	вывести+на+a
vstoupit+v+4	вступить+в+a
odpovědět+na+4	ответить+на+a
zapřáhnout+4	запрячь+g
povolit+3	разрешить+g
obrátit+k+3	повернуть+к+d
chovat+k+3	испытывать+к+d
vypouštět+na+4	выбрасывать+на+a
rozdělit+3	разделить+на+a
procházet+4	проходить+a
najít+na+6	найти+на+l
ochránit+před+7	защитить+от+g
sklánět+4	опускать+g
dobývat+2	добывать+a
hrát+na+4	играть+на+l
vystrčit+4	высунуть+a
ustupovat+před+7	отступать+перед+i
očekávat+od+2	ждать+от+g
odvést+na+6	отвести+в+a
sežrat+4	сожрать+a
volit+7	выбирать+между+i
odnést+pro+4	отнести+в+a
dělat+na+4	производить+на+a
chtít+4	хотеть+a
vycházet+3	исходить+из+g
vést+o+6	вести+на+l
nalepovat+4	наклеивать+на+a
rozumět+3	понимать+a
ztěžovat+4	осложнять+g
jet+3	ехать+к+d
prověřovat+7	проверять+на+a
naplnit+4	наполнить+до+g
telefonovat+3	звонить+в+a
zařadit+do+2	включить+в+a
proběhnout+3	пробежать+к+d
přiblížit+3	приблизить+d
získat+od+2	получить+у+g
psát+7	писать+i
nanést+2	нанести+n
pohřbít+4	похоронить+a
konkurovat+7	конкурировать+с+i
dojít+4	дойти+до+g
přetvářet+4	преобразовывать+в+l
deformovat+4	искажать+a
rozhodnout+4	решить+a
prohrát+4	проиграть+a
česat+4	расчесывать+a
přežít+4	пережить+a
hnát+po+6	гнать+из+g
zabrat+4	занять+a
vařit+z+2	варить+из+g
čekat+na+4	ждать+в+l
zkoušet+7	репетировать+i
vyzradit+4	выдать+a
utéci+od+2	убежать+от+g
pověsit+3	повесить+по+d
vystoupit+proti+3	выступить+против+g
odříznout+od+2	отрезать+от+g
zahrnovat+do+2	включать+от+l
útočit+na+4	нападать+на+a
dopadnout+s+7	приземлиться+между+i
nabrat+2	набрать+g
vyhánět+4	выгонять+из+g
vytýkat+4	порицать+за+a
vpouštět+4	впускать+в+a
rozdávat+4	раздавать+g
zařídit+4	оборудовать+в+l
porodit+4	родить+g
zahnat+4	прогнать+n
zhoršit+4	ухудшить+a
navázat+s+7	завязать+с+i
uvítat+7	встретить+i
udělat+na+4	произвести+на+a
vzbudit+7	вызвать+i
pohybovat+7	шевелить+i
zanechat+4	оставить+после+g
zastupovat+3	представлять+в+l
přitáhnout+7	притянуть+к+d
vyhrát+proti+3	победить+в+l
uvést+7	привести+в+a
panovat+nad+7	владычествовать+над+i
získat+pro+4	привлечь+к+l
utratit+za+4	потратить+на+a
zbývat+3	оставаться+d
listovat+7	листать+a
uvažovat+nad+7	думать+над+i
zaměnit+4	подменить+n
vykřiknout+4	крикнуть+на+l
pokazit+7	испортить+i
nechávat+4	оставлять+a
zabít+3	убить+в+a
utíkat+od+2	бежать+от+g
narazit+o+4	налететь+на+a
nazývat+7	называть+i
osvojovat+4	усваивать+a
zdržet+4	задержать+a
vykládat+4	излагать+a
načrtnout+4	набросать+n
zvednout+proti+3	поднять+против+g
amputovat+4	ампутировать+a
dojet+4	доехать+до+g
vydat+na+4	отдать+на+a
utíkat+k+3	бежать+к+d
strhnout+7	сорвать+с+g
slyšet+od+2	слышать+от+g
spravit+4	починить+a
postavit+do+2	поставить+в+a
realizovat+4	реализовать+a
páchnout+7	вонять+i
napodobit+4	копировать+n
zapalovat+7	зажигать+i
kritizovat+za+4	критиковать+за+a
překvapit+7	удивить+i
jít+do+2	пойти+в+a
nalehnout+na+4	налечь+на+a
převažovat+nad+7	преобладать+над+i
dodržovat+4	соблюдать+a
umořovat+4	погашать+в+a
strkat+do+2	совать+в+a
povědět+3	рассказать+d
přemoci+4	победить+n
vynechat+4	обойти+в+l
stát+4	страна+a
zanechat+v+6	оставить+после+g
usadit+4	усадить+на+a
projít+4	пройти+по+d
poděkovat+3	поблагодарить+a
nalepit+na+4	наклеить+на+a
scházet+3	спускаться+на+a
poznamenávat+7	отмечать+i
pronásledovat+4	преследовать+a
kousat+4	грызть+a
postihnout+4	постигнуть+a
zdvihnout+4	поднять+a
oblékat+4	надевать+g
doplatit+na+4	поплатиться+за+a
předvádět+před+7	демонстрировать+в+l
polévat+7	заливать+i
shazovat+7	сбрасывать+с+g
domluvit+na+4	договориться+о+l
naznačovat+7	указывать+на+a
vydírat+4	шантажировать+g
vyjet+na+4	выехать+на+a
otřást+7	потрясти+a
působit+na+6	действовать+на+l
považovat+za+4	принимать+за+a
zamířit+7	направиться+к+d
sjednocovat+4	объединять+a
zavrhnout+4	отказаться+от+g
povalit+4	повалить+в+n
mít+k+3	держать+в+l
snižovat+4	сокращать+a
cvičit+4	упражняться+в+l
naložit+4	погрузить+в+a
přihodit+k+3	подкинуть+на+a
počítat+s+7	рассчитывать+на+a
přemítat+o+6	думать+о+l
povídat+o+6	говорить+о+l
mívat+4	иметь+a
debatovat+o+6	беседовать+о+l
rozdrtit+7	раздавить+i
učinit+7	сделать+i
rozhýbat+4	размять+n
naříkat+7	жаловаться+на+a
rozdělit+do+2	разделить+на+a
vylákat+4	выманить+a
založit+z+2	основать+на+l
vyřídit+4	передать+a
vychytat+4	выловить+a
zařvat+4	заорать+на+a
poukazovat+4	указывать+на+a
zkoumat+4	рассматривать+a
trápit+7	морить+i
utíkat+3	убегать+от+g
pozvedat+3	поднимать+a
přivést+do+2	привести+в+a
odrazovat+4	отбивать+у+g
přejít+v+4	перейти+на+a
nahradit+7	заменить+a
prolistovat+4	полистать+a
brát+za+4	брать+за+a
věnovat+4	подарить+a
určit+3	предназначить+для+g
prodávat+4	продавать+a
schválit+7	утвердить+путем+g
trpět+4	страдать+от+g
ovlivňovat+7	влиять+на+a
jet+s+7	поехать+с+i
zajistit+proti+3	защитить+от+g
bodat+4	тыкать+в+a
vypálit+po+6	сжечь+после+g
objíždět+4	объезжать+a
přiložit+na+4	наложить+на+a
ozdobit+4	украсить+a
střílet+7	стрелять+по+d
obdržet+z+2	получить+из+g
napájet+7	поить+с+i
vytasit+4	обнажить+a
zajet+na+4	съездить+на+l
pronajímat+4	сдавать+a
pracovat+7	работать+с+i
hostit+4	угощать+g
skočit+4	прыгнуть+под+a
odsoudit+k+3	обречь+на+a
rozevřít+4	раскрыть+a
přejít+7	перейти+из+g
stavět+na+4	ставить+перед+i
přijít+3	прийти+к+d
popravit+4	казнить+a
napovídat+o+6	подсказывать+про+a
přijít+7	прийти+к+d
hvízdat+4	свистеть+в+a
přitisknout+4	прижать+a
udat+3	донести+на+a
doběhnout+4	догнать+a
stěžovat+na+4	жаловаться+на+a
povídat+s+7	говорить+с+i
spát+s+7	спать+с+i
prosit+za+4	просить+от+g
činit+4	делать+a
zjistit+od+2	выяснить+у+g
svážet+4	свозить+a
končit+7	кончаться+i
zasáhnout+do+2	вмешаться+в+a
stěhovat+4	передвигать+a
opakovat+s+7	повторять+о+l
popsat+4	описать+a
držet+7	держать+в+l
koupit+pro+4	купить+для+g
vědět+4	знать+о+l
prověřit+4	проверить+g
dostat+v+6	получить+в+l
zápasit+o+4	бороться+за+a
ručit+za+4	ручаться+за+a
vstřebávat+4	поглощать+a
odpovídat+7	отвечать+i
zažívat+4	испытывать+n
vzít+o+4	взять+на+a
růst+do+2	расти+в+l
vzejít+z+2	возникнуть+из+n
sundat+4	снять+a
přejít+z+2	перейти+на+a
uzavřít+3	закрыть+для+g
propustit+4	уволить+g
jásat+7	ликовать+по+d
vyslovit+4	высказать+a
skrýt+4	скрыть+a
odsunout+4	отложить+в+a
pokládat+na+4	класть+на+a
ochutnávat+4	пробовать+n
kreslit+7	чертить+i
narážet+3	ударяться+в+a
vymetat+4	выметать+a
litovat+2	сожалеть+о+l
vylučovat+4	исключать+a
nahlédnout+na+4	заглянуть+на+a
ospravedlnit+4	оправдать+a
odcházet+od+2	уходить+от+g
napnout+4	натянуть+на+a
udělat+s+7	сделать+с+i
naložit+7	обойтись+с+i
vzít+od+2	взять+у+g
držet+2	держаться+за+a
představit+4	представить+a
volat+3	звонить+d
osvobodit+od+2	освободить+от+g
oznamovat+4	заявлять+о+l
vycházet+od+2	выходить+от+g
vypadat+na+4	выглядеть+на+a
dožívat+2	доживать+до+g
říci+5	сказать+n
slíbit+4	пообещать+n
nahrazovat+4	заменять+g
přejíždět+4	переезжать+в+a
jednat+3	поступать+вопреки+d
překročit+4	переступить+a
pracovat+na+6	работать+над+i
slibovat+3	обещать+d
připevnit+na+4	прикрепить+к+d
předložit+k+3	подать+на+a
strčit+3	сунуть+к+d
střelit+7	стрельнуть+из-под+g
působit+3	вызывать+a
obklíčit+4	окружить+n
vyžadovat+2	требовать+g
doplatit+4	поплатиться+за+a
předkládat+na+4	предъявлять+по+d
dospívat+k+3	приходить+к+d
podniknout+4	предпринять+a
potřebovat+na+4	нуждаться+в+l
manipulovat+s+7	манипулировать+посредством+g
zařazovat+do+2	вносить+в+l
činit+na+4	составлять+около+l
chodívat+4	ходить+к+d
přivézt+3	привезти+в+a
vyzdvihovat+4	подчеркивать+a
zvládnout+4	справиться+с+i
koupit+4	купить+a
dopadat+4	падать+на+a
přijít+s+7	прийти+в+a
vzít+3	взять+у+g
vykreslit+4	нарисовать+a
vypouštět+4	пускать+n
léčit+4	лечить+g
zhotovit+4	изготовить+a
opakovat+o+6	повторить+про+a
vylézt+z+2	вылезти+из+g
zmenšovat+4	уменьшать+a
nadávat+3	обзывать+n
přicházet+3	подходить+d
fouknout+do+2	дунуть+на+a
dělat+s+7	делать+с+i
chránit+2	защищать+от+g
vzít+4	взять+a
sbalit+4	уложить+a
procházet+7	проходить+через+a
volat+na+4	призывать+к+d
zneuctít+4	осквернить+a
dopustit+2	допустить+a
vařit+v+6	варить+в+l
brát+3	отнимать+у+g
vyhlédnout+4	выглянуть+из+g
oddělit+od+2	отделить+от+g
přebírat+za+4	принимать+на+a
řídit+7	управлять+i
prosit+2	просить+g
odstoupit+od+2	отойти+от+g
dorazit+7	добраться+до+g
dosazovat+4	назначать+a
omývat+4	мыть+a
unášet+4	похищать+g
přispět+k+3	внести+в+a
drtit+4	мять+a
stanovit+na+4	определить+на+l
natírat+4	смазывать+a
vkládat+4	вставлять+сквозь+a
přizvat+4	пригласить+в+a
dojet+na+4	доехать+до+g
vytrhovat+4	вырывать+из+g
přesunout+z+2	перебросить+с+g
vypnout+4	выключить+a
vinit+z+2	обвинять+в+l
nahrát+4	записать+a
vidět+7	видеть+i
klást+na+4	класть+на+a
postupovat+3	поступать+в+n
zavírat+4	закрывать+a
zkrotit+4	умерить+a
vytahovat+z+2	вытаскивать+из+g
vlézt+s+7	забраться+с+i
stavět+7	строить+i
vytvářet+4	создавать+a
dosahovat+v+6	достигать+в+l
zareagovat+na+4	отреагировать+на+a
nasadit+na+4	надеть+на+a
zadržet+v+6	задержать+в+l
snášet+s+7	терпеть+с+i
docílit+2	добиться+g
pohnout+7	шевельнуть+i
přijet+k+3	приехать+из+g
ozářit+4	осветить+a
jít+o+4	идти+о+l
přislíbit+3	обещать+d
dávat+3	давать+d
vypravovat+o+6	рассказывать+о+l
blokovat+4	блокировать+a
vyndat+4	вынуть+из+g
nakupovat+2	покупать+g
trestat+7	наказывать+i
převrátit+do+2	опрокинуть+в+a
otevřít+4	открыть+a
nalepit+4	наклеить+на+a
řvát+po+6	орать+на+a
jíst+4	есть+a
kráčet+k+3	идти+к+d
lhát+o+6	лгать+о+l
ohrožovat+4	угрожать+d
uspořádat+4	дать+n
montovat+4	устанавливать+n
začínat+7	начинаться+с+g
strhávat+z+2	срывать+с+g
sníst+4	съесть+a
skrývat+o+6	скрывать+за+i
myslit+o+6	думать+о+l
prodiskutovat+s+7	обсудить+с+i
podložit+7	основать+на+l
zářit+7	сиять+от+g
najmout+4	нанять+g
kopírovat+4	копировать+с+g
promítat+4	показывать+a
ranit+4	ранить+в+a
trestat+za+4	наказывать+за+a
vyhrávat+v+6	играть+на+l
uplést+z+2	сплести+из+g
žádat+od+2	требовать+от+g
vypracovat+na+4	составить+на+a
ukazovat+na+4	указывать+на+a
domluvit+4	договориться+о+l
způsobit+3	нанести+d
dostavět+4	достроить+n
rozestavit+4	расставить+перед+i
hraničit+s+7	граничить+с+i
přinést+4	принести+a
vybavit+3	оснастить+для+g
vytáhnout+4	вытащить+из+g
bojovat+o+4	бороться+за+a
vyjímat+z+2	исключать+из+g
užít+4	использовать+для+g
říkat+7	говорить+в+l
oslabit+4	ослабить+a
odvolávat+4	снимать+с+l
vložit+4	вложить+a
viset+na+6	висеть+на+l
dožít+2	дожить+до+g
zajít+4	зайти+в+a
zaklepat+7	постучать+i
schválit+v+6	утвердить+в+l
vypracovávat+4	разрабатывать+a
obrátit+proti+3	повернуть+к+d
nechávat+3	оставлять+i
strhnout+na+4	увлечь+за+i
pustit+4	отпустить+a
umřít+na+4	скончаться+после+g
oddělovat+4	отделять+g
obletět+4	облететь+a
promluvit+do+2	сказать+в+a
reformovat+4	реформировать+a
nabrat+na+4	набрать+на+a
plodit+4	порождать+a
mávnout+7	махнуть+i
podrobovat+3	подвергать+d
trpět+7	страдать+от+g
opakovat+4	повторять+a
pohřbívat+4	хоронить+a
prosazovat+4	настоять+на+l
honit+3	гоняться+за+i
sejít+3	спуститься+к+d
utéci+k+3	убежать+к+d
nutit+3	вызывать+n
zbavovat+4	лишать+g
ztratit+na+6	потерять+на+l
šířit+4	распространять+a
nastoupit+na+4	поступить+в+a
napomoci+v+6	помочь+в+l
zbystřit+4	напрячь+n
spotřebovávat+4	потреблять+a
zapínat+4	застегивать+a
zasahovat+do+2	вмешиваться+в+a
splynout+s+7	слиться+с+i
kupovat+3	покупать+d
odpovědět+za+4	ответить+за+a
prokázat+4	продемонстрировать+n
uctívat+4	поклоняться+d
spojit+7	объединить+под+i
žít+pro+4	жить+в+l
budit+4	вызывать+у+g
vyzkoušet+4	опробовать+a
probíhat+3	происходить+в+l
nahlížet+na+4	смотреть+на+a
chytat+4	ловить+a
otrávit+7	отравить+i
srovnat+na+4	сравнить+с+g
vzdorovat+3	сопротивляться+d
přiznat+4	признать+a
vodit+s+7	водить+за+i
uvítat+4	приветствовать+g
konzultovat+4	согласовывать+с+i
podrobit+4	подвергнуть+n
propůjčit+3	предоставить+d
odseknout+4	отрубить+от+g
dřímat+v+6	дремать+в+l
hrát+proti+3	играть+против+g
sestupovat+4	сходить+a
zavést+4	ввести+a
odvézt+na+4	отвезти+в+a
namluvit+3	внушить+d
zaútočit+proti+3	напасть+на+a
změkčovat+4	смягчать+n
vyhrát+4	победить+на+l
učit+3	учить+n
klást+3	ставить+a
sevřít+v+4	сжать+в+a
dovolovat+3	позволять+d
připoutat+7	привязать+к+d
minout+2	пройти+сквозь+a
dovážet+4	импортировать+n
zamést+4	замести+в+l
prodávat+3	продавать+к+d
vrátit+4	вернуть+a
odměňovat+4	вознаграждать+g
zveřejňovat+4	публиковать+g
vyjít+na+4	выйти+на+a
narážet+na+4	натыкаться+на+a
šlapat+do+2	топать+в+a
nést+k+3	нестись+к+d
přinášet+4	приносить+a
spatřit+4	увидеть+a
přiložit+4	приложить+a
nalézat+v+6	находить+в+l
umět+s+7	уметь+с+i
racionalizovat+4	рационализировать+g
trénovat+v+6	тренироваться+в+l
zdokonalovat+4	усовершенствовать+a
skoncovat+4	покончить+с+i
smést+4	стереть+с+g
nastoupit+4	поступить+в+a
promluvit+z+2	сказать+в+l
zachytit+2	поймать+на+l
vlastnit+4	владеть+i
ukrást+4	украсть+a
soudit+4	судить+о+l
ochraňovat+4	охранять+a
umývat+4	мыть+g
vyvolávat+4	вызывать+a
označit+7	пометить+i
unést+4	выдержать+a
odebírat+4	отбирать+g
vypadat+z+2	походить+на+a
otřít+4	вытереть+a
vyběhnout+4	выбежать+в+a
rozložit+4	развернуть+a
fantazírovat+o+6	фантазировать+о+l
obejmout+4	обнять+a
probouzet+k+3	пробуждать+к+d
muset+4	должен+a
splácet+4	выплачивать+a
kompenzovat+4	компенсировать+a
povstat+z+2	произойти+от+g
uposlechnout+2	повиноваться+d
mrštit+7	швырнуть+i
dojmout+7	тронуть+g
zavazovat+4	завязывать+a
shodit+4	сбросить+с+g
očistit+od+2	очистить+от+g
dovádět+4	доводить+n
polepit+4	оклеить+n
spát+7	спать+с+i
vzniknout+3	возникнуть+благодаря+d
utíkat+z+2	бежать+из+g
stát+před+7	стоять+перед+i
uchopit+4	схватить+a
rozptýlit+7	разбросать+по+d
srážet+4	сшибать+на+d
přerůst+4	перерасти+в+a
odcházet+3	отходить+d
obvinit+4	обвинить+в+l
zastavět+7	уставить+i
odsuzovat+4	осуждать+g
porušovat+4	нарушать+a
scházet+4	отсутствовать+в+a
vědět+na+4	знать+о+l
odvažovat+2	взвешивать+на+l
porozumět+3	понять+g
obrátit+v+6	повернуть+к+d
tvořit+3	составлять+около+l
přiznat+3	признать+a
přijmout+4	принять+a
odhánět+4	отгонять+a
počítat+za+4	считать+за+a
bít+o+4	биться+за+a
izolovat+4	изолировать+a
zůstávat+bez+2	оставаться+без+g
dělat+z+2	делать+из+g
odnést+4	отнести+a
přicházet+na+4	приходить+в+a
vystupovat+3	выступать+g
táhnout+3	тащить+к+d
určit+4	определить+a
popadnout+7	схватиться+i
zasednout+3	сесть+a
upoutat+4	привлечь+к+d
zneklidňovat+4	беспокоить+g
sundávat+4	снимать+a
zintenzívnit+4	усилить+n
odkázat+3	завещать+d
míchat+7	мешать+в+l
znárodnit+4	национализировать+g
pořádat+4	устраивать+в+l
potvrdit+v+6	подтвердить+для+g
strašit+4	стращать+g
padat+na+4	падать+на+a
zakotvit+4	закрепить+в+l
vyhovět+3	удовлетворить+a
poklesnout+z+2	упасть+относительно+g
dosáhnout+4	дотянуться+до+g
zastavit+na+4	остановиться+в+l
pospíchat+na+4	спешить+на+a
přetvářet+v+4	превращать+в+l
hlasovat+pro+4	голосовать+за+a
vyjíždět+4	выходить+на+a
postrčit+4	подтолкнуть+g
vylíčit+4	описать+a
hlídat+u+2	караулить+у+g
procházet+s+7	проходить+мимо+g
sdružovat+4	объединять+на+l
posílat+4	посылать+a
honit+za+7	гоняться+за+n
polykat+2	глотать+g
křiknout+7	крикнуть+i
jednat+v+6	действовать+в+l
spočívat+7	заключаться+в+l
zahnat+na+4	загнать+на+a
vykročit+na+4	выйти+на+a
zavést+na+4	ввести+после+g
omezit+na+4	ограничить+без+g
žalovat+3	жаловаться+d
rozmýšlet+4	думать+по+d
běžet+3	бежать+к+d
vyběhnout+na+4	выбежать+в+a
ulehčit+3	облегчить+a
zaplnit+7	заполнить+i
hrozit+2	грозить+g
utrpět+7	пострадать+от+g
zemřít+7	умереть+g
připočíst+3	добавить+к+d
pospíchat+k+3	спешить+на+a
pokynout+7	махнуть+i
hledět+na+4	смотреть+на+a
slíbit+za+4	обещать+за+a
polévat+4	заливать+a
stočit+4	свернуть+a
konkurovat+3	конкурировать+с+i
rozvíjet+4	развивать+a
projít+3	пройти+к+d
překonat+4	преодолеть+a
osvobodit+z+2	освободить+от+g
rozdělit+4	разделить+на+a
udržovat+7	поддерживать+с+i
stát+proti+3	стоять+против+g
zůstat+s+7	остаться+с+i
zavraždit+4	убить+g
zastávat+4	придерживаться+g
napravit+4	исправить+a
informovat+4	проинформировать+g
oteplovat+4	нагревать+a
zatížit+7	придавить+i
napojit+7	напоить+i
křiknout+4	крикнуть+a
vypěstovat+4	воспитать+в+l
vystřelit+7	выстрелить+в+a
nakládat+7	обращаться+с+i
vylézt+s+7	вылезти+с+i
padnout+7	упасть+на+a
tajit+o+6	скрывать+от+g
nadlehčit+4	облегчить+a
vyskakovat+z+2	вскакивать+с+g
nosit+na+4	носить+с+i
počínat+v+6	начинать+от+g
vést+proti+3	вести+против+g
hlasovat+4	голосовать+за+a
uložit+7	положить+в+l
fixovat+4	закрепить+в+l
točit+7	вертеть+a
zůstávat+s+7	оставаться+с+i
nastoupit+do+2	поступить+на+a
podpořit+4	поддержать+a
dodávat+do+2	поставлять+в+a
splňovat+4	удовлетворять+d
sdělit+4	сообщить+a
pohybovat+4	шевелить+i
vrazit+4	вонзить+в+a
přispět+3	внести+в+a
volat+o+4	звать+на+a
nakazit+7	заразить+i
vyznačovat+7	выделять+n
přivážet+4	привозить+i
brát+od+2	принимать+у+g
předsedat+3	председательствовать+над+i
nalézat+4	находить+n
dostat+na+6	получить+по+d
odpovědět+4	ответить+на+a
citovat+4	цитировать+g
odejít+od+2	отойти+от+g
naznačovat+o+6	указывать+на+a
říkat+o+6	говорить+о+l
odhlasovat+4	проголосовать+за+a
zdůvodnit+4	оправдать+a
doprovázet+k+3	провожать+до+g
sestoupit+na+4	спуститься+по+d
představovat+3	представлять+d
ohromit+7	изумить+i
narůstat+o+4	расти+на+l
sevřít+4	сжать+a
prchat+před+7	бежать+от+g
přenechat+4	уступить+a
zavřít+na+4	закрыть+за+i
letět+k+3	лететь+в+a
zahnout+3	свернуть+к+d
skrývat+pod+7	скрывать+под+i
rozkládat+4	раскладывать+a
složit+4	сложить+a
klepat+4	стучать+во+a
namáčet+4	макать+в+a
postavit+k+3	поставить+на+a
předurčit+3	предназначить+под+a
zbývat+2	оставаться+g
zvýšit+4	увеличить+a
přisunout+4	придвинуть+к+d
dopravit+7	переправить+на+a
vést+k+3	вести+к+d
bouchnout+7	хлопнуть+i
odejít+na+4	уйти+в+a
přenášet+z+2	передавать+по+d
udeřit+7	ударить+i
vyvádět+4	буйствовать+в+l
komentovat+4	комментировать+a
strčit+za+4	сунуть+в+a
zavinout+4	укутать+n
zarazit+7	остановить+i
objednávat+4	заказывать+a
zajistit+7	обеспечить+g
poskytovat+4	предоставлять+a
přepravovat+7	транспортировать+n
smíchat+4	смешать+a
vzrušit+7	возбудить+i
odlišovat+4	отличать+g
vyjít+4	выйти+на+a
instalovat+4	установить+в+l
uvést+4	привести+a
dovolit+4	позволить+a
posloužit+3	послужить+d
vydávat+na+4	тратить+на+a
zajíždět+s+7	въезжать+на+l
vyšetřit+4	расследовать+a
poroučet+3	приказывать+d
projíždět+4	проезжать+по+l
ucházet+o+4	уходить+в+a
vyplatit+4	выплатить+a
brousit+4	точить+a
překonat+7	преодолеть+с+i
zahajovat+4	начинать+a
číst+4	читать+a
probouzet+4	пробуждать+к+d
sklouznout+k+3	соскользнуть+по+d
míchat+4	мешать+a
vyrazit+z+2	выскочить+из+g
cpát+7	запихивать+в+a
proměnit+7	превратить+в+a
obdržet+na+4	получить+от+g
vystoupit+3	выступить+против+g
otravovat+4	отравлять+a
načechrat+4	взъерошить+a
odevzdat+4	отдать+a
svlékat+4	снимать+a
zacházet+v+6	обращаться+по+d
přivést+k+3	привести+к+d
honit+4	гоняться+за+i
pomoci+k+3	помочь+на+l
obracet+k+3	обращать+к+d
obývat+4	жить+в+l
přidržovat+4	придерживать+a
ovlivnit+v+6	повлиять+на+a
zřídit+4	создать+для+g
utvrzovat+v+6	утверждать+в+l
prohánět+4	гонять+a
vyjet+4	выехать+на+a
ztrojnásobit+4	утроить+g
svést+4	соблазнить+a
zlepšovat+4	улучшать+a
číst+o+6	читать+о+l
promluvit+s+7	выступить+на+l
navrátit+3	вернуть+к+d
mluvit+v+6	говорить+о+l
přikročit+k+3	подойти+к+d
dostát+3	сдержать+a
charakterizovat+4	характеризовать+n
křičet+na+4	кричать+на+a
vytáhnout+na+4	вытащить+на+a
upadat+do+2	впадать+в+a
téci+3	течь+из+g
dopravit+na+4	доставить+на+a
nasypat+4	насыпать+в+l
odvést+3	отвести+в+a
vypořádat+s+7	расправиться+с+i
nabízet+3	предлагать+d
říci+o+6	сказать+о+l
vypadávat+z+2	выпадать+из+g
čelit+3	противостоять+d
vyjasňovat+4	выяснять+a
uzavírat+4	заключать+a
myslit+s+7	думать+о+l
vzít+7	взять+i
založit+3	основать+на+l
odsunovat+4	отодвигать+g
předložit+3	подать+на+a
zahřívat+4	греть+в+l
mluvit+s+7	говорить+с+i
přejít+na+4	перейти+на+a
vyrážet+s+7	выдавливать+из+g
zaujímat+4	занимать+в+l
vysvětlit+4	объяснить+a
napomáhat+3	способствовать+d
klepat+o+4	стучать+о+l
navrhnout+4	предложить+a
odvádět+od+2	отвлекать+от+g
jet+na+6	ехать+на+l
rozšířit+4	расширить+a
dorůst+na+4	вырасти+на+l
snížit+o+4	сократить+к+l
dotvrzovat+4	подтверждать+n
pokrývat+4	покрывать+a
ničit+4	разрушать+a
připadnout+do+2	перейти+в+a
zavřít+7	закрыть+за+i
nahnat+4	нагнать+n
zvyšovat+4	увеличивать+a
ustoupit+od+2	отказаться+от+g
zajet+k+3	заехать+к+d
uzavřít+4	закрыть+a
rozložit+mezi+4	распределить+между+i
přijet+v+6	приехать+в+a
prásknout+7	хлопнуть+i
přivázat+4	привязать+a
poskytnout+3	предоставить+d
táhnout+s+7	тащить+к+d
přilákat+4	привлечь+a
nacházet+na+6	находить+на+l
pronikat+7	проникать+сквозь+a
seřadit+do+2	выстроить+в+a
podlehnout+3	поддаться+d
projít+s+7	пройти+сквозь+a
cenit+2	ценить+n
brát+na+4	брать+на+a
unavit+4	устать+от+g
vznikat+7	формироваться+благодаря+d
otevřít+3	открыть+для+g
pomoci+s+7	помочь+с+i
postupovat+4	продвигаться+к+d
brát+do+2	брать+в+a
vykonat+4	совершить+n
odhadovat+4	оценивать+в+l
podřídit+3	подчинить+g
ulovit+4	поймать+a
diktovat+3	диктовать+g
pomstít+4	отомстить+за+a
cvičit+v+6	упражняться+в+l
přeceňovat+4	переоценивать+a
utrácet+za+4	тратить+на+a
dovolovat+4	позволять+a
zajít+k+3	зайти+к+d
doplňovat+4	дополнять+n
tancovat+4	танцевать+без+g
poslouchat+z+2	слушать+со+i
vypustit+na+4	выпустить+на+a
vědět+z+2	знать+по+d
vyjasnit+4	выяснить+a
spojovat+4	сочетать+в+l
zavést+3	ввести+в+a
působit+4	действовать+на+a
diktovat+4	диктовать+a
roztrhat+na+4	разорвать+на+l
donutit+do+2	принудить+к+d
zvážit+4	оценить+a
vzdálit+3	отдалить+от+g
využít+2	воспользоваться+i
trhat+od+2	срывать+с+i
nazvat+4	назвать+n
převzít+2	принять+на+a
přijímat+za+4	принимать+за+a
zvednout+na+4	поднять+к+d
pohánět+4	двигать+i
pocházet+od+2	исходить+от+g
probírat+7	перебирать+a
dostávat+4	получать+a
přilévat+4	подливать+g
jít+s+7	пойти+с+i
zabavit+4	арестовать+g
šlapat+4	шагать+за+i
odletět+na+4	улететь+на+a
žasnout+nad+7	недоумевать+при+l
směřovat+na+4	направляться+на+a
sjíždět+7	скатываться+с+g
měnit+4	менять+a
hodit+3	бросить+d
ucházet+3	уходить+в+a
diverzifikovat+4	диверсифицировать+a
plavat+4	плавать+в+n
provádět+4	проводить+a
vykročit+7	зашагать+по+d
oslovit+4	обратиться+к+d
pobavit+4	позабавить+g
zanechat+2	оставить+после+g
obtěžovat+4	приставать+к+d
zazpívat+o+6	спеть+про+a
čerpat+z+2	черпать+из+g
rozlišovat+7	различать+g
zůstávat+v+6	оставаться+в+l
zatajovat+4	утаивать+a
zvažovat+4	взвешивать+a
bojovat+mezi+7	сражаться+за+a
přednášet+4	преподавать+в+l
přispět+7	внести+в+a
zůstat+bez+2	остаться+без+g
narážet+4	натыкаться+на+a
přikládat+3	придавать+d
iniciovat+4	инициировать+n
podrobovat+4	подвергать+n
upravit+7	подготовить+при+l
stavět+3	проводить+в+l
utéci+před+7	убежать+от+g
pojmenovat+4	назвать+a
pojistit+3	застраховать+от+g
spolupracovat+v+6	сотрудничать+в+l
skočit+pro+4	сбегать+за+i
omezit+7	ограничить+i
odzbrojit+4	разоружить+g
plnit+7	наполнять+при+l
foukat+do+2	дуть+в+a
kombinovat+4	сочетать+в+l
potrestat+7	наказать+в+l
skončit+7	закончиться+i
odvést+na+4	отвести+в+a
konsolidovat+4	консолидировать+a
poukazovat+7	указывать+на+a
ctít+4	чтить+g
zatelefonovat+3	позвонить+d
vyhazovat+4	вскидывать+a
skákat+pro+4	прыгать+в+a
pohlédnout+3	поглядеть+на+a
praštit+4	ударить+a
skončit+v+6	закончиться+в+l
ovlivnit+4	повлиять+на+a
poznat+2	узнать+по+d
přestoupit+k+3	перейти+в+a
chtít+na+4	хотеть+на+a
natočit+na+4	записать+на+a
předvolat+4	вызвать+a
odhazovat+4	бросать+a
zavěsit+4	привесить+к+d
koupit+od+2	купить+у+g
vyvést+4	вывести+из+g
pouštět+k+3	подпускать+к+d
otrávit+4	отравить+a
vykreslit+3	нарисовать+d
mlátit+4	лупить+a
uhádnout+4	угадать+a
vyplňovat+4	заполнять+a
dávat+na+4	давать+на+a
přislíbit+4	обещать+a
nakreslit+4	нарисовать+a
doprovázet+4	сопровождать+n
usmrcovat+4	умерщвлять+g
přezkoumat+4	пересмотреть+g
natáhnout+k+3	протянуть+к+d
vypínat+4	выключать+a
tahat+7	тянуть+в+a
zapálit+4	зажечь+a
odesílat+4	посылать+в+a
vytahovat+na+4	извлекать+из+g
namířit+4	направить+на+a
spočítat+4	пересчитать+a
cítit+4	чувствовать+g
dávat+4	давать+a
podstrčit+3	подсунуть+d
narazit+7	наткнуться+на+a
udělat+7	сделать+с+i
zůstat+z+2	остаться+от+l
předkládat+4	предъявлять+d
prodat+3	продать+d
sedět+nad+7	сидеть+над+i
vyzkoušet+na+6	проверить+на+a
vytlačovat+4	оттеснять+n
varovat+2	предупреждать+об+l
zjednat+4	навести+a
vstupovat+do+2	вступать+в+a
stavět+4	строить+n
připravit+na+4	подготовить+к+d
nazývat+4	называть+a
dokazovat+4	доказывать+n
soudit+za+4	судить+за+a
nalézt+na+6	обнаружить+на+l
vytrhnout+3	вырвать+у+g
obchodovat+7	торговать+i
dosahovat+2	доходить+до+g
angažovat+4	вовлечь+в+a
sílit+4	расти+в+a
vézt+v+6	везти+в+l
běhat+3	бегать+к+d
spadnout+o+4	упасть+на+l
pojistit+na+4	застраховать+на+a
doběhnout+7	добежать+с+i
překlenout+4	преодолеть+a
ožívat+v+6	оживать+в+l
napovědět+3	подсказать+d
převést+na+4	перевести+по+d
podržet+4	подержать+g
přiběhnout+na+4	подбежать+ко+d
pojídat+4	поедать+n
napravovat+4	исправлять+a
vystavovat+4	подвергать+g
upřít+4	устремить+на+a
zvýraznit+4	подчеркнуть+a
sedět+za+4	сидеть+во+a
vykládat+3	объяснять+d
vytáhnout+z+2	вынуть+из+g
vylétnout+4	вылететь+из+g
vyloučit+4	исключить+из+g
způsobovat+4	вызывать+n
udělovat+4	давать+a
tvořit+7	составлять+с+i
odcestovat+na+4	уехать+на+a
zamykat+4	запирать+a
obdržet+od+2	получить+от+g
odvrátit+4	отвести+a
vykřikovat+na+4	кричать+на+a
hovořit+proti+3	говорить+в+a
psát+o+4	писать+о+l
sázet+4	ставить+на+a
dovézt+na+4	довезти+до+g
uvalit+4	наложить+a
zabalit+4	завернуть+a
obviňovat+4	обвинять+g
sdílet+4	разделять+n
pohlídat+4	покараулить+a
dát+s+7	поставить+посреди+g
odrážet+4	отражать+a
orientovat+4	ориентировать+a
schovávat+před+7	скрывать+от+g
naříkat+na+4	жаловаться+на+a
přerušovat+v+6	обрывать+на+l
ovlivňovat+4	влиять+на+a
přenechat+3	оставить+d
prožít+4	пережить+a
ztratit+3	растерять+g
přerušit+v+6	прервать+на+l
převést+4	перевести+a
definovat+4	определять+a
nadzvednout+4	приподнять+a
vštěpovat+3	прививать+d
vyvracet+4	выворачивать+a
sejít+na+6	сбиться+с+g
potřásat+7	трясти+i
kazit+4	портить+a
lhát+3	лгать+d
unikat+3	ускользать+от+g
sebrat+3	отнять+у+g
formovat+4	формировать+a
mávat+4	махать+d
přijímat+do+2	принимать+в+a
napravovat+3	исправлять+a
stát+s+7	стать+с+i
prodat+4	продать+a
sloužit+3	служить+d
oplatit+4	отплатить+i
ukazovat+4	показывать+a
pohrdat+7	презирать+g
vidět+4	видеть+a
nařizovat+4	предписывать+g
zažít+4	пережить+a
shledat+4	признать+a
vylézat+z+2	вылезать+из+g
obeznámit+s+7	ознакомить+с+i
postřílet+4	перестрелять+a
umřít+7	умереть+в+l
přistoupit+k+3	подойти+к+d
odkázat+4	завещать+a
očistit+4	почистить+g
zachránit+3	спасти+d
vyjmout+z+2	вынуть+из+g
oživovat+4	оживать+в+l
zaběhnout+4	забежать+к+d
stočit+do+2	свернуть+из+g
namalovat+4	нарисовать+a
znát+z+2	знать+по+l
kázat+4	проповедовать+a
přizpůsobovat+3	приспосабливать+под+a
odvodit+4	вывести+a
přiletět+na+4	прилететь+на+a
zvítězit+o+4	победить+с+i
dělit+7	делить+с+i
měřit+4	замерять+a
zmírňovat+4	смягчать+i
přijíždět+na+4	приезжать+из-за+g
začínat+s+7	начинать+со+g
vyjíždět+na+6	выезжать+от+g
zanechat+po+6	оставить+после+g
vyčleňovat+4	выделять+на+a
pohlcovat+4	поглощать+a
posílit+7	укрепить+с+i
vyvrátit+4	опровергнуть+на+l
mít+7	думать+о+l
domluvit+na+6	договориться+с+i
ležet+s+7	лежать+на+l
přijít+o+4	прийти+на+a
obkličovat+4	окружать+n
ušít+4	сшить+a
dotovat+4	субсидировать+a
natáhnout+4	протянуть+a
náležet+3	принадлежать+к+d
vybrat+za+4	взять+на+a
přiletět+k+3	прилететь+к+d
nastolit+4	установить+a
přednést+4	прочитать+g
zpomalovat+4	замедлять+a
myslit+4	думать+о+l
dovolit+3	позволить+d
mávnout+3	махнуть+в+a
ukrýt+4	спрятать+a
nabírat+4	набирать+a
zvyknout+4	привыкнуть+к+d
zahřívat+7	согревать+в+l
pomoci+3	помочь+d
rozbít+4	разбить+о+a
zvát+4	приглашать+на+a
strhnout+4	сорвать+a
rozdat+v+6	раздать+в+l
hlásat+4	проповедовать+n
přijmout+s+7	принять+с+i
vodit+za+4	водить+за+i
pobírat+4	получать+a
postřehnout+4	заметить+g
pokračovat+s+7	продолжаться+с+i
určit+k+3	предназначить+для+g
záležet+3	заключаться+в+l
potěžkávat+4	взвешивать+в+l
přehlížet+4	игнорировать+a
zaostávat+za+7	отставать+от+g
překvapit+4	удивить+a
upravit+4	поправить+a
spustit+na+4	опустить+на+a
zpozorovat+4	заметить+на+d
přijet+na+4	приехать+к+d
sklonit+4	опустить+a
rozbíjet+4	бить+a
urovnat+4	урегулировать+a
jednat+o+6	говорить+о+l
ladit+4	настраивать+по+d
šokovat+4	шокировать+g
dovádět+3	доводить+до+g
vymést+4	вымести+из+l
dostávat+z+2	получать+из+d
pozvat+k+3	пригласить+к+d
patřit+3	принадлежать+к+d
vyjádřit+4	выразить+a
malovat+4	рисовать+a
vyléčit+4	вылечить+a
oslovit+7	обратиться+к+d
přinášet+3	приносить+d
uvést+do+2	привести+в+a
vyrůstat+o+4	вырастать+из+g
doplnit+4	дополнить+a
zmobilizovat+4	мобилизовать+a
projevovat+4	проявлять+n
šetřit+na+6	экономить+на+n
píchat+4	колоть+a
mobilizovat+4	мобилизовать+n
povolat+k+3	вызвать+к+d
vyhovovat+3	соответствовать+d
hrozit+3	грозить+l
vyrazit+7	вытолкать+в+a
říci+na+4	сказать+в+a
sebrat+z+2	поднять+с+g
přiložit+3	приложить+к+d
zjistit+u+2	выяснить+у+g
uplést+4	заплести+a
transformovat+4	преобразовать+a
inklinovat+k+3	склоняться+к+d
připsat+3	отнести+на+a
vyvíjet+4	разрабатывать+a
pamatovat+na+4	помнить+о+l
sledovat+4	следить+за+i
odstrašovat+4	отпугивать+g
počítat+4	считать+g
ustavit+4	создать+a
lákat+4	привлекать+g
vinit+za+4	винить+кроме+g
sloužit+7	служить+под+i
zasypávat+7	осыпать+i
převýšit+4	превысить+a
vyzbrojit+7	вооружить+i
odemknout+4	открыть+a
odříznout+4	отрезать+a
operovat+7	оперировать+a
ochromit+4	парализовать+n
vtrhnout+k+3	ворваться+к+d
ohlásit+3	объявить+d
vrhnout+4	бросить+a
připočíst+k+3	добавить+к+d
připisovat+k+3	приписывать+к+d
zlikvidovat+4	уничтожить+a
dávat+k+3	ставить+перед+i
upevňovat+4	укреплять+над+i
zatáhnout+4	потянуть+за+a
přidělovat+3	распределять+между+i
souhlasit+s+7	согласиться+с+i
posunout+o+4	передвинуть+на+a
lehnout+7	лечь+с+i
okusit+4	отведать+a
zalévat+7	лить+из-под+g
dopadat+na+4	падать+на+a
uschovat+4	сохранить+a
spotřebovat+4	израсходовать+на+a
zanést+3	отнести+d
napsat+4	написать+a
odstrčit+4	отодвинуть+a
přivítat+7	встретить+в+n
vyzkoušet+3	примерить+к+d
vybudovat+z+2	построить+от+g
napadat+4	нападать+на+a
poznamenat+3	заметить+между+i
umírat+7	умирать+от+g
dělit+o+4	делить+с+i
studovat+4	изучать+a
odložit+3	отложить+благодаря+d
lámat+4	ломать+a
přepravit+4	переправить+из+g
otevírat+4	открывать+a
poskytovat+3	предоставлять+d
užít+2	использовать+для+g
potopit+do+2	погрузить+в+a
znát+4	знать+g
vyslýchat+4	допрашивать+в+l
přidělovat+k+3	распределять+между+i
vysázet+4	посадить+n
vyhrát+na+6	выиграть+у+g
stavět+před+4	ставить+перед+i
delegovat+4	делегировать+a
přeběhnout+4	перебежать+через+a
zahájit+7	вступить+в+a
jezdit+na+4	ездить+на+a
obsadit+4	занять+a
obrátit+na+4	устремить+на+a
přehodnotit+4	переосмыслить+a
slibovat+4	обещать+a
přejmenovat+na+4	переименовать+в+a
ustoupit+z+2	отказаться+от+g
čistit+4	чистить+a
třímat+4	сжимать+a
působit+na+4	действовать+на+a
číst+3	читать+в+l
přesahovat+4	превышать+a
vyplnit+4	выполнить+a
zahnout+v+4	завернуть+за+a
tasit+4	обнажить+a
dělat+na+6	делать+на+l
moci+za+4	мочь+за+a
jezdit+3	ездить+в+l
platit+za+4	платить+за+a
sežrat+2	сожрать+g
usnadňovat+4	облегчать+a
krmit+7	кормить+i
chystat+k+3	готовить+на+a
vysypat+4	ссыпать+на+a
nabrat+4	набрать+a
uhasit+4	потушить+a
zacházet+s+7	обращаться+с+i
pozorovat+7	следить+за+i
zakrýt+před+7	закрыть+от+g
narovnávat+4	разгибать+под+i
skladovat+4	хранить+a
odhadovat+na+4	оценивать+в+l
rozdělit+7	распределить+i
obléknout+4	надеть+a
ušetřit+na+6	сэкономить+на+l
pořizovat+4	покупать+в+a
vévodit+3	возвышаться+над+i
uložit+3	положить+в+l
umýt+4	вымыть+a
držet+s+7	держать+под+a
vyhlásit+4	объявить+a
dostat+7	получить+a
mluvit+4	говорить+о+l
připravovat+na+4	готовить+к+d
sladit+s+7	согласовать+с+i
stavět+proti+3	проводить+в+l
chtít+za+4	хотеть+за+a
sdělit+3	сообщить+об+l
shromáždit+4	собрать+под+i
prosit+o+4	просить+у+g
odnést+3	отнести+d
oslavovat+4	праздновать+a
obohacovat+4	обогащать+a
promluvit+o+6	выступить+насчет+g
uvalovat+4	налагать+a
představovat+4	представлять+a
korigovat+4	корректировать+n
porážet+4	опрокидывать+g
otočit+na+4	повернуть+на+a
napsat+o+6	написать+о+l
pozdravit+s+7	поздороваться+с+i
posílat+na+4	посылать+на+a
počínat+3	начинать+от+g
vyplivnout+4	выплюнуть+на+a
přivážet+7	привозить+из+g
předvádět+4	исполнять+g
koupat+4	купать+a
přivést+4	привести+к+d
stát+za+4	стать+за+a
upozorňovat+4	указывать+на+a
pouštět+4	отпускать+a
vyprovodit+4	проводить+g
sebrat+k+3	подобрать+на+l
vyrazit+na+4	выскочить+на+a
doplňovat+7	дополнять+a
zajít+v+6	зайти+в+l
přesvědčit+4	убедить+g
věřit+4	верить+в+a
jásat+nad+7	ликовать+по+d
vynakládat+4	прилагать+n
zůstávat+na+6	оставаться+на+l
přebírat+2	принимать+на+a
donutit+k+3	принудить+к+d
spočívat+v+6	заключаться+в+l
zkomplikovat+4	усложнить+a
přidržet+4	придержать+a
krájet+4	резать+a
sestoupit+4	спуститься+по+d
obouvat+4	надевать+a
viset+nad+7	висеть+над+i
zdolat+4	преодолеть+n
přemístit+na+4	перевести+на+a
pronášet+4	произносить+g
přemýšlet+o+6	думать+о+l
ukazovat+na+6	указывать+на+a
přetvořit+4	преобразовать+a
vozit+4	возить+в+l
vypadnout+z+2	выпасть+из+g
cpát+4	совать+в+a
pochopit+4	понять+a
zdržovat+4	задерживать+g
porazit+v+6	победить+с+i
proměnit+v+4	превратить+в+a
zápasit+s+7	бороться+с+i
skřípat+7	скрипеть+от+g
donutit+7	принудить+к+d
zdůrazňovat+4	подчеркивать+a
podmínit+7	обусловить+i
bolet+4	болеть+a
přihlásit+4	зарегистрировать+a
usnadňovat+3	облегчать+d
přiblížit+k+3	приблизить+к+d
zdůraznit+4	подчеркнуть+a
mluvit+3	говорить+с+i
zdiskreditovat+4	дискредитировать+a
proměnit+s+7	превратить+в+a
dospívat+2	приходить+к+d
proměňovat+4	превращать+в+a
jednat+na+4	действовать+в+a
zjednodušovat+3	облегчать+для+g
rozříznout+4	разрезать+a
odvézt+7	увезти+в+a
obdržet+4	получить+a
pokřikovat+4	кричать+d
převládat+nad+7	превалировать+над+g
zahrnovat+3	включать+в+a
darovat+3	подарить+d
uvažovat+s+7	думать+меж+i
demolovat+4	разрушать+a
obléci+4	надеть+a
zadržet+4	задержать+a
předpovídat+4	предсказывать+n
přitáhnout+4	притянуть+к+d
připadat+2	приходиться+около+l
zredukovat+4	сократить+a
rozmotat+4	распутать+a
odjíždět+na+4	уезжать+на+a
zapojit+do+2	вовлечь+в+a
získat+4	получить+a
utřít+4	вытереть+a
konzultovat+s+7	согласовывать+с+i
odhlasovat+3	проголосовать+за+n
debatovat+s+7	беседовать+с+i
ohlásit+4	объявить+о+l
žádat+na+6	требовать+от+g
vzít+s+7	взять+с+i
dýchat+7	дышать+i
uvážit+4	рассмотреть+a
předložit+4	предложить+a
položit+3	положить+d
nechávat+na+6	оставлять+на+l
lézt+3	лезть+из+g
vtrhnout+na+4	ворваться+во+a
scházet+7	спускаться+по+d
začínat+4	начинаться+с+g
pověřit+4	поручить+g
odcizit+4	украсть+a
vysvětlit+3	объяснить+d
stanovovat+7	устанавливать+через+a
pokrýt+7	покрыть+i
děkovat+3	благодарить+за+a
zaplatit+4	заплатить+за+a
dirigovat+4	дирижировать+i
vzniknout+z+2	возникнуть+из+g
postupovat+k+3	поступать+в+n
přestupovat+4	переходить+в+a
přitáhnout+na+4	притянуть+к+d
ujet+4	проехать+с+n
šilhat+po+6	коситься+на+a
srovnávat+s+7	сравнивать+с+i
získat+na+4	привлечь+на+a
zastavit+před+7	остановиться+перед+i
přivřít+4	прикрыть+a
odolávat+3	сопротивляться+d
zamítnout+4	отклонить+a
říci+7	сказать+i
fotografovat+4	фотографировать+a
ukončit+4	выйти+из+g
darovat+4	подарить+a
uznávat+4	признавать+g
paralyzovat+4	парализовать+a
měnit+do+2	превращать+в+a
vydržet+4	выдержать+a
dovolit+2	разрешить+для+g
přerůstat+do+2	перерастать+во+a
žádat+o+4	просить+у+g
zůstat+v+6	остаться+в+l
skládat+do+2	складывать+из+g
uplatit+4	подкупить+за+a
dusit+4	подавлять+g
poukázat+na+4	указать+на+a
jíst+7	есть+с+i
schvalovat+4	одобрять+g
projednat+4	обсудить+a
zůstat+při+6	остаться+с+i
utrhnout+4	оторвать+a
natrhnout+4	надорвать+a
přišít+4	пришить+a
klesat+z+2	падать+на+l
absorbovat+4	поглощать+a
zůstat+za+7	остаться+за+i
stahovat+4	стягивать+a
přistupovat+k+3	подходить+к+d
vnucovat+4	навязывать+a
vystupovat+proti+3	выступать+против+g
oklamat+4	обмануть+g
projednávat+4	обсуждать+a
zvát+7	называть+i
vylézt+4	влезть+на+a
hnát+4	мчаться+на+a
kývat+3	кивать+a
schválit+4	одобрить+a
odeslat+4	отправить+a
vystavět+4	выстроить+a
vyslechnout+4	выслушать+a
střílet+4	стрелять+в+a
naříkat+4	жаловаться+на+a
přecházet+od+2	переходить+от+g
přeložit+4	перевести+a
pochovat+4	похоронить+в+l
vzrůst+do+2	увеличиться+на+l
upustit+4	уронить+a
myslet+4	думать+о+l
mlčet+o+6	молчать+об+l
vést+3	вести+к+d
zjednodušit+4	упростить+g
zrazovat+4	предавать+a
bodat+7	тыкать+в+a
dopadnout+4	упасть+на+a
tajit+7	скрывать+g
vyprávět+3	рассказывать+о+l
poskytnout+4	предоставить+a
bušit+3	стучать+у+g
hlásit+4	докладывать+о+i
stvořit+4	сотворить+a
odrazit+4	отбросить+a
nakázat+3	приказать+во+l
ušetřit+2	избавить+от+g
zabít+4	убить+a
vznášet+4	поднимать+a
odvažovat+na+6	взвешивать+на+l
zprostit+2	освободить+от+g
vléci+4	тащить+a
sloužit+4	служить+i
zaručovat+3	гарантировать+d
zaslat+4	отправить+a
určit+pro+4	предназначить+для+g
odvětit+4	ответить+с+i
platit+3	платить+d
vyhodit+4	выбросить+a
rozebrat+na+4	разобрать+на+a
zosobňovat+4	воплощать+в+l
spatřit+v+6	увидеть+в+l
vyrazit+3	отправиться+в+a
uspokojit+4	удовлетворить+a
nastupovat+na+4	вступать+на+a
odebrat+4	отобрать+у+g
rozmíchat+4	размешать+a
porazit+4	победить+a
bývat+7	бывать+перед+i
nalévat+4	разливать+a
klesnout+z+2	упасть+с+l
zasáhnout+4	охватить+a
jít+po+6	идти+по+d
zjistit+o+6	узнать+про+a
nechat+2	оставить+у+g
hrát+za+4	играть+за+a
zanechávat+v+6	оставлять+в+l
minout+4	миновать+a
trvat+na+6	настаивать+на+l
odolat+3	выдержать+a
trpět+3	страдать+от+g
přivézt+7	привезти+в+a
ležet+3	лежать+в+l
prohlašovat+4	объявлять+i
zahrnout+7	засыпать+i
odletět+4	отлететь+в+a
předvádět+3	показывать+d
rodit+4	рожать+в+l
skočit+k+3	сбегать+за+i
vidět+3	видеть+в+l
dosáhnout+2	достичь+g
vážit+4	взвешивать+g
trestat+4	наказывать+за+a
změnit+4	изменить+a
privatizovat+4	приватизировать+a
přicházet+s+7	приходить+в+a
obdivovat+4	восхищаться+i
hnout+pro+4	двинуть+ради+g
srovnat+s+7	сравнить+с+g
podrobit+3	подвергнуть+d
rozeznávat+4	различать+g
vynutit+na+6	добиться+при+l
vyběhnout+s+7	выбежать+в+a
vodit+na+4	водить+в+a
ponořit+4	погрузить+a
vyznamenat+7	наградить+i
zpívat+4	петь+a
obejít+4	обойти+с+i
chytit+4	схватить+a
ujet+7	уехать+i
probíhat+4	осуществляться+l
chodit+s+7	ходить+с+i
obsluhovat+4	обслуживать+g
vymazat+4	стереть+a
spěchat+k+3	спешить+к+d
nabídnout+4	предложить+a
pronikat+4	проникать+в+a
dýchnout+7	дохнуть+на+a
přerůstat+4	перерастать+в+a
běhat+4	бегать+в+l
připojit+k+3	подключить+к+d
rýsovat+4	чертить+g
vyvádět+na+4	выводить+на+a
omluvit+za+4	извинить+за+a
nutit+4	заставлять+g
prohlásit+za+4	заявить+о+l
běhat+na+4	бегать+по+d
plést+s+7	путать+с+i
očekávat+4	ожидать+g
obnovit+4	восстановить+a
naklonit+4	склонить+a
uvažovat+o+6	думать+о+l
zlomit+7	сломить+при+l
jít+za+7	идти+за+i
zazvonit+na+4	позвонить+в+a
omluvit+4	оправдать+n
ustoupit+3	отступить+перед+i
odpovědět+7	ответить+на+a
vyčítat+4	упрекать+за+a
složit+do+2	сочинить+на+a
odečíst+od+2	вычесть+из+g
vyměňovat+4	обменивать+на+a
otáčet+4	поворачивать+a
pálit+po+6	палить+из+l
převzít+3	принять+к+d
dokázat+4	доказать+a
posílit+na+4	усилить+на+l
vyjednávat+4	договариваться+о+l
zastřelit+4	застрелить+со+i
přehodit+4	накинуть+на+a
rozpoutat+4	развязать+a
křičet+4	кричать+на+a
uznat+7	признать+в+l
podstrčit+4	подбросить+a
běžet+k+3	бежать+к+d
cítit+7	чувствовать+i
pomstít+za+4	отомстить+за+a
upozornit+4	указать+a
chtít+od+2	хотеть+от+g
obklopit+7	окружить+i
tahat+4	тянуть+за+a
složit+na+4	сочинить+на+a
kopat+4	рыть+a
živit+4	питать+a
ukázat+7	указать+на+a
odlétat+na+4	улетать+на+a
směnit+za+4	обменять+на+a
vítat+4	приветствовать+g
udělat+3	сделать+со+i
plavat+7	плавать+в+l
příslušet+k+3	принадлежать+к+d
vyslat+4	послать+a
dát+7	вложить+в+a
uctít+4	почтить+a
ukrývat+4	прятать+a
odepřít+4	отказать+в+l
rozšířit+na+4	распространить+на+a
utrpět+4	потерпеть+a
vštípit+3	привить+d
zařvat+na+4	заорать+на+a
utéci+s+7	удрать+с+i
protahovat+7	растягивать+с+i
přeměnit+z+2	превратить+из+g
strašit+7	пугать+i
krýt+7	прикрывать+n
odlétnout+na+4	отлететь+в+a
zalepit+4	заклеить+на+a
ulevit+7	облегчить+путем+g
zastihnout+4	застать+a
upomínat+na+4	напоминать+о+l
operovat+4	оперировать+g
vést+na+4	вести+в+a
doprovodit+4	проводить+g
stoupat+na+4	подниматься+по+d
zajet+4	съездить+на+l
ulehčovat+4	облегчать+n
opravovat+4	поправлять+a
potřít+4	уничтожить+n
odsouvat+4	откладывать+a
hrát+o+4	играть+по+d
vylézt+k+3	взобраться+на+a
umýt+7	смыть+с+g
tlouci+7	стучать+i
ohlásit+7	сообщить+a
demoralizovat+4	деморализовать+n
ratifikovat+4	ратифицировать+a
tlačit+do+2	давить+в+a
odkazovat+na+4	ссылаться+на+a
nařizovat+3	приказывать+d
cvičit+na+6	упражняться+в+n
sestávat+z+2	состоять+из+g
odeslat+3	отправить+для+g
zavřít+před+7	закрыть+перед+i
nahlížet+4	смотреть+на+a
zašívat+4	штопать+a
rozdělit+s+7	разбить+на+a
poradit+3	посоветовать+d
zmírnit+na+4	уменьшить+в+l
vytvořit+z+2	создать+из+g
zvát+na+4	приглашать+на+a
uvádět+na+4	приводить+в+l
stát+z+2	стать+в+l
dorazit+v+6	добраться+до+n
připravit+k+3	подготовить+к+d
přijímat+4	принимать+a
lámat+nad+7	ломать+над+i
podepsat+na+6	подписать+на+l
svrhnout+4	свергнуть+a
objasnit+3	объяснить+d
stěžovat+3	жаловаться+d
houpat+v+6	качаться+в+l
dominovat+3	доминировать+в+l
přidat+3	добавить+d
plout+7	плыть+d
popřát+2	пожелать+g
poukázat+4	указать+на+a
vypravovat+3	рассказывать+d
připevnit+7	прикрепить+к+l
znamenat+7	означать+i
přetvářet+na+4	преобразовывать+в+l
vydat+3	сдать+d
čekat+4	ждать+g
otočit+7	повернуть+a
usmrtit+7	убить+i
tahat+s+7	таскать+за+i
narůst+3	вырасти+у+g
zahrozit+7	погрозить+i
otočit+3	повернуть+к+d
kvést+7	расцветать+под+i
ztělesňovat+4	воплощать+n
stanovovat+4	устанавливать+a
vytesat+4	изваять+a
prominout+4	простить+a
vidět+do+2	видеть+в+l
zamíchat+7	перетасовать+a
přijít+k+3	прийти+в+a
vyměnit+4	заменить+a
navrhovat+na+4	представлять+на+a
získat+3	привлечь+к+l
zakrýt+4	закрыть+a
poslouchat+4	слушать+a
proběhnout+7	пройти+в+l
nalít+2	налить+в+a
navrhovat+3	предлагать+d
vláčet+4	волочить+a
vztahovat+k+3	протягивать+к+d
znít+3	звучать+для+g
přečkat+4	переждать+n
vzpomenout+4	припомнить+a
dodávat+na+4	поставлять+на+n
čerpat+7	черпать+из+g
natahovat+4	натягивать+a
vyhrožovat+7	угрожать+i
pustit+z+2	выпустить+из+g
přicházet+k+3	приходить+к+d
vydržet+bez+2	устоять+без+g
koupit+za+4	купить+за+a
snížit+7	снизить+посредством+g
milovat+4	любить+a
mazat+4	мазать+a
omezit+4	ограничить+a
cenit+4	ценить+n
ovlivňovat+v+6	влиять+на+l
valit+4	катить+перед+i
opisovat+4	описывать+n
chodit+3	ходить+в+a
aplikovat+4	применять+a
pohledět+na+4	поглядеть+на+a
nechat+na+6	оставить+на+l
odtáhnout+4	оттащить+за+a
odvracet+od+2	отвращать+от+g
dohánět+4	догонять+a
odpovídat+na+4	отвечать+на+a
povzbudit+4	поощрить+n
uskutečňovat+4	проводить+при+l
dát+k+3	дать+на+a
považovat+4	считать+i
vyměnit+za+4	заменить+за+a
směňovat+za+4	обменивать+на+a
namířit+7	направить+на+a
přijet+po+6	приехать+на+a
rozdělovat+4	разделять+a
předat+3	передать+d
svázat+7	связать+с+i
propojit+4	соединять+i
zkusit+7	попробовать+i
nahrazovat+7	заменять+n
zodpovídat+za+4	отвечать+за+a
hledět+2	смотреть+на+a
užívat+2	употреблять+g
vsunout+4	сунуть+в+a
odmítat+3	отказывать+в+l
přečíst+o+6	прочитать+в+l
přijmout+na+4	принять+в+a
zachovat+4	сохранить+a
zachytit+4	поймать+a
vyvažovat+4	балансировать+между+i
šlápnout+3	наступить+d
plout+po+6	плавать+в+l
zformovat+4	создать+под+i
zkusit+na+6	попробовать+на+l
povolit+4	разрешить+a
vyprovokovat+4	спровоцировать+a
roztrhat+4	разорвать+на+l
vytvořit+7	создать+с+i
nasazovat+4	надевать+a
odjet+na+6	уехать+с+i
předvést+4	показать+a
diskutovat+s+7	обсуждать+с+i
přidat+v+6	добавить+про+a
sklízet+4	пожинать+a
zabíjet+7	убивать+i
hospodařit+s+7	хозяйничать+с+i
sbalit+do+2	уложить+в+a
běhat+za+7	бегать+к+d
vystřihovat+z+2	вырезать+из+g
mít+2	иметь+g
psát+3	писать+d
zasypat+7	засыпать+i
strhat+4	сорвать+с+g
přispívat+3	способствовать+g
líbat+4	целовать+a
přisuzovat+4	приписывать+n
rozpustit+4	распустить+a
zvýšit+na+4	усилить+на+l
sáhnout+3	прибегнуть+к+d
nabádat+k+3	призывать+к+d
přiřknout+4	присудить+a
hovořit+3	говорить+i
proměnit+4	превратить+в+a
zjistit+4	узнать+a
sbližovat+4	сближать+g
dorazit+na+4	добраться+до+g
skýtat+4	давать+a
uvádět+4	приводить+к+d
rozpouštět+4	распускать+g
odradit+od+2	отбить+у+g
spravovat+4	управлять+i
stoupat+7	подниматься+по+d
docházet+2	происходить+во+l
zapisovat+4	записывать+в+a
dělat+7	делать+с+i
objednat+4	заказать+a
zhotovovat+4	делать+a
aktivovat+4	активизировать+a
klesnout+na+4	опуститься+на+a
instruovat+4	инструктировать+n
seznámit+4	ознакомить+n
řešit+7	решить+g
pohlédnout+na+4	посмотреть+на+a
zastavit+4	остановить+a
objet+4	объехать+a
zvětšovat+4	увеличивать+a
vyjednávat+s+7	договариваться+с+i
drát+4	проволока+a
nahradit+3	заменить+на+a
zemřít+za+4	умереть+через+a
navléknout+3	надеть+на+a
zakoupit+pro+4	купить+для+g
vládnout+3	управлять+i
projektovat+4	проектировать+g
vracet+3	возвращать+d
přesahovat+o+4	превышать+на+l
získat+z+2	получить+у+g
obětovat+4	пожертвовать+i
vynášet+4	выносить+a
odložit+4	отложить+a
dopustit+4	допустить+g
pozvat+na+4	пригласить+на+a
posílat+3	посылать+d
vyzdobit+4	украсить+a
padat+s+7	падать+на+a
přijmout+bez+2	принять+без+g
brojit+proti+3	бороться+с+i
přihodit+3	подкинуть+на+a
znepokojovat+4	беспокоить+a
padnout+na+4	упасть+на+a
povstat+proti+3	восстать+против+g
rozhodnout+proti+3	решить+в+l
špehovat+4	подглядывать+за+i
zklamat+4	подвести+g
chodit+na+4	ходить+на+a
dostávat+7	получать+a
komunikovat+s+7	общаться+с+i
promlouvat+3	выступать+перед+i
zvednout+3	поднять+к+d
přemístit+4	перевести+на+a
patřit+do+2	принадлежать+к+d
stáhnout+z+2	снять+с+g
zachycovat+7	улавливать+в+l
přepadnout+4	напасть+на+a
zdravit+4	здороваться+с+i
sázet+na+4	ставить+на+a
přizvat+k+3	пригласить+к+d
žít+4	жить+в+l
chovat+4	питать+a
zatahovat+4	впутывать+в+a
užívat+k+3	применять+в+l
navodit+4	создать+a
volit+4	избирать+g
představit+v+6	представить+в+l
vyjít+od+2	выйти+от+g
táhnout+za+4	тащить+за+a
zapnout+4	включить+a
zásobit+7	снабдить+i
sestrojit+4	построить+a
zavázat+4	завязать+i
určit+na+4	предназначить+для+g
zranit+4	ранить+a
upustit+od+2	отказаться+от+g
vidět+2	видеть+g
sepsat+4	написать+a
rozvinout+4	развить+a
jet+7	ехать+в+l
rozehrávat+4	разыгрывать+a
odstrčit+7	отодвинуть+i
najít+s+7	найти+в+l
snášet+4	выдерживать+ради+g
přecházet+na+4	переходить+на+a
rozlišovat+4	различать+n
chodit+za+4	ходить+в+a
vést+v+6	вести+к+d
dělit+4	делить+g
přelézt+4	переползти+с+g
pozdravit+4	поздороваться+с+i
vybudovat+4	создать+a
vyměřit+4	установить+a
trpět+pro+4	страдать+от+g
vozit+3	возить+к+d
ubít+4	убить+a
pronést+o+6	произнести+над+i
podporovat+4	поддерживать+a
odjet+k+3	отправиться+к+d
usadit+7	усадить+на+a
zapříčinit+4	вызвать+n
trhat+na+4	срывать+с+i
prohlubovat+4	углублять+a
proběhnout+bez+2	пройти+без+g
bombardovat+4	бомбить+n
umožňovat+3	позволять+d
urazit+4	оскорбить+n
klepnout+4	стукнуть+по+d
zabít+7	убить+i
skupovat+4	скупать+n
trpět+za+4	страдать+за+a
prát+4	стирать+a
strhávat+4	срывать+a
odjet+na+4	уехать+на+a
přijíždět+7	подъезжать+к+d
kritizovat+4	критиковать+за+a
poslat+k+3	послать+к+d
skoncovat+s+7	покончить+с+i
uvádět+v+4	вводить+в+a
tvrdit+3	твердить+d
zhasínat+4	тушить+a
pronést+4	произнести+a
pokazit+4	испортить+a
kolísat+v+6	колебаться+в+l
shodovat+na+6	соглашаться+с+i
odbourat+4	устранить+a
skrývat+před+7	прятать+от+g
začlenit+4	принять+по+d
vozit+7	возить+a
rozhodit+4	раскинуть+a
dovádět+k+3	доводить+до+g
normalizovat+4	нормализовать+g
vytvářet+3	создавать+для+g
ponechat+na+6	оставить+в+l
usilovat+3	стремиться+к+d
kývnout+7	кивнуть+i
skákat+4	прыгать+a
udeřit+4	ударить+a
vyhnat+4	выгнать+в+a
položit+4	положить+a
odčerpat+4	отсосать+a
rozbít+na+4	разбить+о+a
padnout+3	рухнуть+под+i
zaručovat+4	гарантировать+a
shodovat+v+6	сходиться+во+l
dýchat+4	дышать+i
doporučovat+4	рекомендовать+a
připustit+4	допустить+g
poslat+4	послать+a
zacházet+7	обращаться+с+i
jmenovat+4	назначать+g
prohrávat+4	проигрывать+a
přispívat+k+3	способствовать+в+l
potvrzovat+4	подтверждать+a
záviset+na+6	зависеть+от+g
zapochybovat+o+6	усомниться+в+l
vrhnout+na+4	бросить+на+a
způsobit+7	привести+к+d
odskakovat+k+3	отскакивать+к+l
dojít+na+4	дойти+до+g
postát+4	постоять+у+g
přečíst+4	прочитать+a
strčit+do+2	сунуть+в+a
obsahovat+4	содержать+a
nalepit+7	приклеить+i
utéci+na+4	убежать+в+a
omezovat+4	ограничивать+a
odcházet+na+4	уходить+в+a
stát+7	стать+i
sjíždět+po+6	скатываться+по+d
popřít+4	опровергнуть+n
natočit+7	повернуть+к+d
hlasovat+o+6	проголосовать+за+n
rozmístit+4	расставить+по+d
předpokládat+4	предполагать+a
svěřovat+3	поверять+d
bít+s+7	биться+с+i
udělat+z+2	сделать+из+g
jít+za+4	выходить+за+a
obdivovat+3	восхищаться+i
vyhodit+za+4	выставить+за+a
potřebovat+k+3	нуждаться+в+l
uvést+3	привести+к+d
vystřelit+4	выстрелить+в+a
dospět+2	прийти+к+d
udeřit+na+4	ударить+по+l
nabízet+4	предлагать+a
umlčovat+4	заглушать+a
přepisovat+4	переписывать+a
přilétat+k+3	подлетать+к+d
klepnout+o+4	стукнуть+по+d
natáčet+4	снимать+a
platit+4	платить+за+a
odebrat+3	отобрать+у+g
osvětlovat+4	освещать+a
vytěžit+z+2	извлечь+из+g
snížit+4	уменьшить+a
uzavírat+s+7	заключать+с+i
demonstrovat+3	демонстрировать+d
dopadnout+na+4	упасть+на+a
poprosit+o+4	попросить+у+g
dát+3	дать+d
školit+4	обучать+g
umístit+4	поставить+перед+i
hrát+s+7	играть+с+i
odlišit+od+2	отделить+от+g
natáhnout+na+4	надеть+на+a
umožnit+3	позволить+d
odtrhovat+4	отрывать+g
odebrat+z+2	забрать+у+g
prožívat+4	переживать+a
chránit+před+7	защищать+от+g
vymýtit+4	искоренить+a
dojít+k+3	прийти+к+d
tlumit+4	гасить+n
studovat+na+4	учиться+на+a
obvinit+z+2	обвинить+в+l
projevovat+3	проявлять+d
shrnout+7	сгрести+в+n
zvolit+7	избрать+i
navrhnout+3	предложить+d
kouřit+4	курить+a
potkat+4	встретить+a
zamítnout+3	отказать+в+l
přidělit+k+3	прикрепить+к+d
experimentovat+s+7	экспериментировать+с+i
vonět+7	пахнуть+i
utrhnout+3	оторвать+у+g
přehánět+4	преувеличивать+a
vnucovat+3	навязывать+d
dopřát+3	дать+d
rovnat+4	поправлять+a
organizovat+4	организовывать+a
dodat+4	доставить+a
povýšit+4	выдвинуть+на+a
koukat+na+4	глядеть+на+a
ovládnout+4	охватить+i
začít+s+7	начать+с+g
sundat+3	снять+со+g
předurčit+7	предопределить+i
poztrácet+4	растерять+в+l
hledat+4	искать+a
využít+4	использовать+a
zahubit+4	погубить+a
pomoci+na+4	помочь+в+a
určit+7	предназначить+для+g
vyřešit+4	решить+a
bdít+nad+7	заботиться+о+l
schválit+3	утвердить+путем+g
zasypávat+4	засыпать+a
ponechat+4	оставить+в+l
potřebovat+od+2	нуждаться+в+a
vést+4	вести+a
pomyslet+na+4	подумать+о+l
udělit+3	наградить+a
obklopovat+7	окружать+i
probíhat+s+7	происходить+в+l
pomoci+4	помочь+a
děsit+2	пугать+g
utíkat+na+4	бежать+на+a
eliminovat+4	устранить+a
roztáhnout+4	раздвинуть+a
dohlížet+nad+7	надзирать+за+i
zmírnit+4	смягчить+a
zužitkovat+4	использовать+в+l
osvětlit+4	осветить+a
srovnávat+4	сравнивать+с+g
hlásit+3	докладывать+о+l
splatit+4	выплатить+a
řvát+na+4	орать+на+a
připadat+3	казаться+d
vyrozumět+z+2	понять+из+g
projíždět+7	проезжать+мимо+g
sesadit+4	отстранить+g
chybovat+4	ошибаться+перед+l
popisovat+4	описывать+a
vytetovat+4	вытатуировать+у+g
odlétnout+4	отлететь+в+a
svírat+4	сжимать+a
využívat+pro+4	пользоваться+в+l
přidávat+4	прибавлять+n
tlačit+4	давить+на+a
zvýšit+3	повысить+для+g
souhlasit+v+6	согласиться+с+i
štěkat+na+4	лаять+на+a
vědět+od+2	знать+о+l
vyčleňovat+na+4	выделять+на+a
pramenit+z+2	исходить+от+g
podpořit+v+6	поддержать+в+l
zaplatit+za+4	заплатить+за+a
páchat+4	совершать+g
podepřít+4	подпереть+a
přirovnávat+4	сравнивать+n
vykrást+4	ограбить+до+g
maximalizovat+4	максимизировать+a
zajít+3	зайти+к+d
vidět+s+7	увидеть+в+l
směřovat+k+3	направляться+на+a
udržovat+s+7	поддерживать+с+i
obcházet+4	обходить+a
přimět+4	заставить+g
nařídit+4	поставить+по+d
dostat+3	получить+от+g
podložit+4	подложить+a
skákat+na+4	прыгать+на+l
přivést+na+4	привести+к+d
padat+3	падать+на+a
žárlit+na+4	ревновать+к+l
vybrat+4	выбрать+a
vyhnat+na+4	изгнать+из+l
odjet+7	уехать+с+i
klesat+na+4	слабеть+по+d
odhalit+4	обнаружить+a
zahazovat+4	выбрасывать+a
nahlédnout+4	заглянуть+в+a
poklesnout+7	упасть+в+l
sevřít+3	сжать+a
ukazovat+3	показывать+d
vysvětlovat+7	объяснять+перед+i
prodloužit+4	продлить+a
udržet+7	удержаться+от+g
přizpůsobovat+4	приспосабливать+под+a
hodit+4	бросить+a
chtít+na+6	хотеть+о+l
připisovat+4	приписывать+к+d
odpovídat+3	соответствовать+d
přivázat+k+3	привязать+к+d
mít+z+2	носить+в+l
sklidit+4	собрать+a
překračovat+4	превышать+в+a
ukrást+pro+4	украсть+для+g
poznávat+4	узнавать+g
vyfotografovat+4	сфотографировать+a
táhnout+z+2	идти+вдоль+g
litovat+4	жалеть+об+l
přidat+4	добавить+a
nastupovat+4	вступать+на+a
usvědčovat+4	изобличать+a
přát+4	желать+g
vyskočit+na+4	вскочить+на+a
požadovat+o+4	требовать+от+g
ustupovat+od+2	отказываться+от+g
rušit+4	нарушать+a
zmačkat+4	скомкать+a
vypravovat+4	рассказывать+a
vytvořit+pro+4	создать+для+g
vozit+v+6	возить+в+l
navázat+7	завязать+с+i
spolupracovat+při+6	сотрудничать+в+l
vyhrožovat+3	угрожать+d
učinit+4	сделать+a
povýšit+na+4	выдвинуть+на+a
chtít+k+3	хотеть+о+l
zatknout+4	арестовать+g
sejít+s+7	спуститься+к+d
zapůsobit+na+4	воздействовать+на+a
zakrýt+7	закрыть+i
řvát+7	орать+g
vzít+za+4	взять+за+a
kroužit+7	кружить+над+i
chránit+4	защищать+a
lovit+4	охотиться+на+a
zrychlit+4	ускорить+a
odnést+na+4	отнести+на+a
odebrat+od+2	отнять+у+g
odrazovat+od+2	отбивать+у+g
zodpovědět+4	ответить+на+a
předejít+4	избежать+g
vytrhnout+z+2	выхватить+из+g
sjíždět+4	спускаться+в+l
zasáhnout+7	вмешаться+с+i
přemoci+7	победить+i
vyhnat+do+2	выгнать+в+a
vyjednávat+3	договариваться+с+i
bojkotovat+4	бойкотировать+a
brát+4	брать+a
pronajmout+4	снять+a
odejít+3	отойти+к+d
angažovat+v+6	вовлекать+в+a
zhasnout+4	потушить+a
rozdrtit+4	раздавить+g
zdvojnásobit+4	удвоить+a
sjet+7	спуститься+l
nechat+za+4	оставить+за+i
poškodit+4	повредить+d
investovat+4	инвестировать+в+a
chytit+za+4	схватить+за+a
sázet+s+7	ставить+на+a
odmítnout+3	отказаться+от+g
doplácet+na+4	расплачиваться+за+a
stisknout+3	нажать+на+a
setřít+4	стереть+a
použít+k+3	использовать+для+g
potopit+4	утопить+a
chápat+4	понимать+a
podceňovat+4	недооценивать+n
vštípit+4	привить+n
doporučit+4	порекомендовать+g
rozdělit+na+4	разделить+на+a
zaměřit+4	сосредоточить+на+l
zestátnit+4	национализировать+a
vyslat+3	направить+в+a
vézt+3	везти+d
odrazit+v+6	отразить+в+l
vyčítat+3	упрекать+g
urážet+4	оскорблять+g
rvát+na+4	рвать+в+a
vylézt+na+4	влезть+на+a
vyjímat+4	исключать+g
zahnout+do+2	свернуть+с+g
přenášet+4	переносить+a
sejmout+4	снять+a
praštit+7	ударить+i
sbírat+pro+4	собирать+для+g
vyučovat+v+6	преподавать+в+l
odepřít+3	отказать+в+l
přistihnout+4	застичь+g
zahýbat+4	сворачивать+за+a
oslabit+na+4	ослабить+в+l
směrovat+4	направлять+a
rozdělit+mezi+7	распределить+между+i
vypustit+z+2	выпустить+из+g
udělat+4	сделать+a
filtrovat+4	фильтровать+a
vybrat+7	выбрать+между+i
spolupracovat+s+7	сотрудничать+с+i
používat+4	использовать+a
přispívat+4	способствовать+g
vzít+do+2	взять+в+a
udržet+s+7	удержаться+на+l
zařadit+k+3	включить+в+a
vytáhnout+7	вытащить+из+g
zahlédnout+4	увидеть+a
přepsat+4	переписать+a
přehodit+7	перебросить+через+a
trhat+4	срывать+с+i
zmenšit+4	сократить+a
svírat+7	сжимать+i
přiřknout+3	присудить+g
zašermovat+7	замахать+i
založit+7	основать+между+i
rozdělovat+mezi+4	распределять+по+d
plakat+4	плакать+об+l
slyšet+4	слышать+a
vstupovat+v+4	вступать+в+a
zhotovit+z+2	сделать+из+g
napsat+3	написать+d
propouštět+4	увольнять+g
chodívat+3	ходить+к+d
sestoupit+k+3	спуститься+к+d
barvit+4	красить+a
vázat+4	связывать+с+i
pročesávat+4	прочесывать+g
ležet+v+6	лежать+в+l
zapadnout+do+2	погрузиться+в+a
říkat+4	говорить+a
přetrvat+4	сохраниться+на+l
vybírat+z+2	выбирать+из+g
promýšlet+4	обдумывать+a
líbat+3	целовать+d
vyslovovat+4	произносить+a
rozlišit+4	различить+g
hořet+7	гореть+i
vyhrát+v+6	выиграть+в+a
přejmenovat+4	переименовать+в+a
patřit+mezi+4	принадлежать+к+d
postoupit+k+3	двинуться+в+l
pozvat+4	пригласить+на+a
stavět+z+2	ставить+перед+i
vést+za+4	вести+за+a
obnovovat+4	восстанавливать+n
převyšovat+4	превышать+a
vyjít+z+2	выйти+из+g
zalévat+4	поливать+a
přitahovat+4	привлекать+g
uškrtit+4	задушить+g
motivovat+4	мотивировать+g
brzdit+4	тормозить+a
signalizovat+4	сигнализировать+о+l
vyhlašovat+4	заявлять+о+l
konkurovat+v+6	конкурировать+с+i
osvobodit+4	освободить+a
střílet+z+2	стрелять+из+g
zorganizovat+4	организовать+a
utvářet+4	формировать+a
uložit+na+4	уложить+на+a
vylévat+4	выливать+в+a
potírat+4	бороться+с+i
šeptat+4	шептать+посреди+g
oznámit+3	сообщить+d
restrukturalizovat+4	реструктурировать+a
kolísat+mezi+7	колебаться+между+i
točit+4	снимать+a
eskortovat+4	конвоировать+a
šetřit+4	беречь+a
nosit+4	носить+a
vymýšlet+4	придумывать+n
tisknout+na+6	прижимать+к+l
žertovat+s+7	шутить+с+i
prokázat+7	продемонстрировать+a
zabránit+7	воспрепятствовать+путем+g
zahánět+4	отгонять+от+g
nakoupit+4	закупить+a
přesunout+4	переместить+на+a
podílet+na+6	участвовать+в+l
odvézt+v+6	увезти+с+i
rozsvítit+4	зажечь+a
chodit+4	ходить+по+d
nalít+3	налить+в+a
přikrýt+4	прикрыть+a
opouštět+4	покидать+a
převzít+4	принять+на+a
nechat+3	оставить+d
liberalizovat+4	либерализовать+a
kopnout+7	пнуть+i
vyjádřit+3	выразить+d
zůstat+po+6	остаться+в+l
sladit+7	согласовать+с+i
dostávat+2	получать+от+g
dopravit+na+6	доставить+с+g
narazit+s+7	столкнуться+с+i
stáhnout+7	снять+с+g
rozeznat+4	различить+a
nazvat+7	назвать+i
jet+k+3	ехать+в+a
neutralizovat+4	нейтрализовать+n
odletět+na+6	улететь+на+l
požádat+4	попросить+у+g
vytlačit+4	вытеснить+a
hovořit+4	говорить+о+l
zajít+na+4	сходить+в+a
zaručit+7	обеспечить+посредством+g
chodívat+k+3	ходить+к+d
uslyšet+4	услышать+a
podávat+4	подавать+a
splynout+v+4	слиться+в+a
prozkoumat+4	обследовать+a
kousnout+4	укусить+за+a
hnát+z+2	нестись+по+d
vpustit+4	впустить+g
upadnout+v+4	впасть+в+a
přenést+3	перенести+к+d
trefit+7	попасть+в+a
přestupovat+na+4	переходить+в+a
plout+v+6	плыть+в+l
přikládat+k+3	прикладывать+к+d
vychovávat+4	растить+g
upomínat+4	напоминать+о+l
pomáhat+7	помогать+i
oslavit+4	отметить+n
zaznamenávat+4	регистрировать+a
vyjít+s+7	выйти+из+g
zůstat+na+6	остаться+на+l
držet+v+6	держать+в+l
hledět+3	глядеть+на+a
opřít+o+4	прислонить+к+d
strčit+4	сунуть+a
psát+o+6	писать+о+l
promyslet+4	продумать+a
zapomínat+na+4	забывать+о+l
vybrat+z+2	выбрать+средь+g
postavit+před+4	поставить+перед+i
pokrývat+7	покрывать+i
odhalovat+4	обнажать+a
vyplácet+4	выплачивать+g
zbořit+4	разрушить+a
zanechávat+po+6	оставлять+за+i
vzniknout+7	произойти+от+g
utřít+7	вытереть+i
mluvit+z+2	говорить+с+g
potřebovat+4	нуждаться+в+l
jezdit+po+6	ездить+по+d
dopřát+4	дать+a
uchovávat+4	сохранять+a
dohodnout+4	договориться+о+l
zahalit+4	окутать+a
obklopovat+4	окружать+a
vonět+4	пахнуть+i
rozčilovat+4	расстраивать+a
přivézt+na+4	привезти+на+a
otočit+k+3	повернуть+к+d
stihnout+4	успеть+a
docházet+k+3	происходить+в+a
strkat+za+4	совать+за+a
náležet+k+3	принадлежать+к+d
objevit+4	обнаружить+a
chrlit+4	изрыгать+a
opatřit+4	устроить+на+l
způsobit+4	привести+к+d
přemáhat+4	подавлять+g
šlápnout+na+4	наступить+на+a
vystupňovat+4	усилить+n
dodat+3	придать+d
běžet+na+4	бежать+на+a
sehnat+3	раздобыть+на+l
stoupnout+na+4	подняться+до+l
připadnout+2	достаться+после+g
odcházet+s+7	уходить+с+i
eliminovat+7	устранить+с+i
vyhnat+z+2	выгнать+из+g
zapomínat+4	забывать+о+l
mít+od+2	владеть+с+g
pomáhat+3	помогать+d
uplatňovat+4	применять+n
chytat+za+4	хватать+за+a
sloužit+k+3	служить+для+g
vzbudit+4	вызвать+a
bojovat+za+4	бороться+за+a
uvést+v+4	поставить+на+a
dopřávat+3	давать+g
doporučovat+3	советовать+d
spadnout+na+4	упасть+на+a
přidělit+3	определить+в+a
splývat+v+4	сливаться+в+a
nabádat+4	побуждать+g
nabírat+3	черпать+в+l
zajet+na+6	заехать+на+a
zaostat+za+7	отстать+в+l
vyzývat+k+3	призывать+к+d
svrhnout+na+4	сбросить+на+a
dorůst+4	дорасти+до+g
šlapat+na+4	ступать+по+l
zaspat+4	проспать+a
uvařit+3	приготовить+на+a
nasbírat+2	собрать+из+g
vyklidit+4	освободить+a
věnovat+3	посвятить+d
mít+4	иметь+a
připoutat+4	привязать+a
nalévat+2	наливать+a
odejmout+3	лишить+g
vracet+4	возвращать+a
ozbrojit+7	вооружить+i
jezdit+4	ездить+на+a
obětovat+3	пожертвовать+ради+l
odeslat+na+4	отправить+на+a
usilovat+o+4	стремиться+к+d
konstatovat+4	констатировать+a
obnášet+4	составлять+около+l
smířit+4	примирить+l
postoupit+3	двинуться+в+l
zaútočit+7	напасть+на+a
ustanovit+4	установить+a
řvát+4	орать+в+a
zvednout+4	поднять+a
zamířit+k+3	направиться+к+d
škodit+3	вредить+d
slavit+4	славить+g
usednout+k+3	сесть+за+a
znemožňovat+3	препятствовать+d
udržovat+4	поддерживать+a
vyrůst+z+2	вырасти+из+g
imitovat+4	имитировать+n
žehnat+3	благословлять+с+g
přemítat+nad+7	размышлять+над+i
snést+4	вынести+g
předběhnout+4	опередить+a
střelit+z+2	выстрелить+из+g
zachytit+za+4	зацепиться+за+a
vypuzovat+4	изгонять+n
zacházet+4	обращаться+с+i
seřadit+4	выстроить+n
zodpovídat+4	отвечать+за+a
prodlužovat+4	продлевать+g
ztížit+4	усложнить+a
křičet+7	кричать+от+g
utéci+3	убежать+от+g
čekat+od+2	ждать+от+g
přicházet+4	приходить+a
ohlašovat+7	объявлять+о+l
nabídnout+3	предложить+d
pracovat+s+7	работать+с+i
zabrzdit+4	затормозить+у+g
mířit+7	направляться+к+d
hnát+za+7	нестись+за+i
svědčit+o+6	свидетельствовать+о+l
chytit+2	схватить+за+a
počkat+s+7	подождать+с+i
plést+7	путать+с+i
slyšet+o+6	слышать+о+l
přirovnat+4	сравнить+a
koncentrovat+4	сосредоточить+в+l
velet+3	командовать+i
pozměnit+4	изменить+a
uklidit+4	убрать+в+a
činit+7	составлять+около+l
vycházet+z+2	исходить+из+g
dovést+4	привести+a
projít+7	пройти+через+a
hlasovat+proti+3	проголосовать+против+g
svolávat+4	созывать+g
zapomenout+4	позабыть+о+l
končit+4	кончать+a
dojít+3	подойти+к+d
sedět+na+6	сидеть+на+l
umožnit+4	позволить+a
zkoušet+na+6	пробовать+на+l
zachytit+7	схватить+i
vyvážet+4	экспортировать+a
hltat+4	глотать+a
zaznamenat+4	зарегистрировать+в+l
zbavit+4	лишить+g
porušit+4	нарушить+a
limitovat+4	ограничить+до+g
zapalovat+4	зажигать+a
shořet+při+6	сгореть+при+l
zdědit+po+6	унаследовать+от+g
pouštět+3	запускать+a
spisovat+4	писать+о+l
zasluhovat+4	заслуживать+g
jít+od+2	идти+от+g
uzamknout+4	запереть+в+l
přeskočit+4	перепрыгнуть+через+a
klepat+7	стучать+i
podléhat+3	поддаваться+d
spěchat+s+7	спешить+ко+d
lámat+7	ломать+над+i
rozložit+na+4	разложить+на+a
převážit+4	перевесить+a
vyjíždět+7	выезжать+со+i
sehrát+4	сыграть+a
narušit+4	нарушить+a
použít+na+4	воспользоваться+без+g
pěstovat+4	разводить+a
vyjadřovat+4	выражать+a
poprosit+4	попросить+у+g
provést+4	провести+a
urazit+7	оскорбить+i
zakazovat+4	запрещать+a
záležet+na+6	зависеть+от+g
zrcadlit+4	отражать+a
naznačovat+4	указывать+на+a
růst+3	рост+d
zpracovávat+4	перерабатывать+a
ponechat+3	оставить+d
strhnout+z+2	сорвать+с+g
setrvávat+v+6	пребывать+в+l
pokřtít+4	окрестить+g
přijmout+za+4	взять+на+a
zbavovat+2	лишать+g
připomenout+3	напомнить+d
zahrát+4	сыграть+в+a
prohlédnout+4	осмотреть+a
políbit+4	поцеловать+a
poklesnout+o+4	упасть+на+l
zachycovat+2	собирать+g
patřit+na+4	относиться+к+d
přivítat+4	встретить+в+n
prorazit+7	пробить+i
osvobozovat+4	освобождать+a
obžalovat+z+2	обвинить+в+l
mrštit+4	швырнуть+в+a
říci+za+4	сказать+за+a
nahradit+4	заменить+a
urychlovat+4	ускорять+a
běhat+po+6	бегать+по+d
tleskat+3	рукоплескать+d
vyjít+za+7	выйти+за+i
přikládat+4	придавать+g
honit+s+7	гоняться+за+i
dostat+2	получить+от+g
učinit+3	сделать+против+g
ohřát+4	разогреть+a
mučit+4	мучить+n
osvěžit+4	освежить+в+l
rozlišit+7	отличить+от+g
zvýšit+o+4	увеличить+на+l
přecházet+do+2	ходить+из+g
tahat+za+4	тянуть+за+a
nadchnout+4	воодушевить+a
odvést+k+3	отвести+к+d
učinit+na+4	сделать+для+g
vzbuzovat+4	внушать+g
zakopat+4	закопать+в+a
přesvědčit+o+6	убедить+в+l
vtáhnout+4	втянуть+a
volat+s+7	призывать+к+d
okrást+4	обокрасть+g
probírat+4	перебирать+a
předcházet+4	предшествовать+d
pozvednout+4	повысить+a
podniknout+v+6	предпринять+для+g
svádět+4	сваливать+на+a
tahat+do+2	таскать+в+a
maskovat+4	маскировать+n
zvítězit+v+6	победить+на+l
zkreslit+4	исказить+a
nacházet+4	находить+a
přijet+7	приехать+к+d
prohlašovat+za+4	заявлять+о+l
vystopovat+4	проследить+за+i
zabouchnout+4	захлопнуть+a
přistoupit+na+4	согласиться+на+a
odjet+v+6	отправиться+в+l
naučit+4	научить+g
sdělovat+o+6	сообщать+о+l
tepat+4	стучать+в+a
nastavit+3	подставить+d
zavést+k+3	провести+к+d
doplácet+4	расплачиваться+за+a
převažovat+4	перевешивать+g
zaručit+4	гарантировать+a
poslechnout+4	послушать+a
hájit+4	защищать+a
obracet+4	переворачивать+a
šít+4	шить+d
regulovat+4	регулировать+a
minout+7	пройти+вдоль+g
přestoupit+na+4	перейти+в+a
stát+3	стоять+на+l
odnášet+4	уносить+a
vycítit+4	почувствовать+n
zabavit+7	занять+i
důvěřovat+3	доверять+d
informovat+o+6	информировать+о+l
stříkat+4	брызгать+на+a
utratit+4	потратить+на+a
napadnout+7	напасть+на+a
rozšířit+o+4	расширить+до+g
odvádět+na+4	уводить+на+a
vtahovat+4	втаскивать+в+a
trvat+3	настаивать+на+l
prohlašovat+o+6	заявлять+о+l
protrhnout+4	прорвать+a
předejít+7	предотвратить+посредством+g
doufat+v+4	надеяться+на+a
kontrolovat+4	контролировать+a
vytvořit+4	создать+a
jet+v+6	ехать+в+l
posunout+4	передвинуть+на+a
akumulovat+4	накопить+a
držet+za+4	держаться+за+a
vnutit+3	навязать+d
uniknout+před+7	ускользнуть+от+g
svítit+3	освещать+a
stát+o+4	стать+в+l
uklidňovat+4	успокаивать+g
uvidět+v+6	увидеть+в+l
donést+4	принести+a
prohrát+o+4	проиграть+с+i
popsat+7	описать+i
potřást+7	потрясти+i
hrát+v+4	играть+в+a
odmítnout+4	отказаться+от+g
vlézt+k+3	влезть+к+d
spočívat+na+6	лежать+на+l
chytat+7	хватать+за+a
prásknout+4	хлопнуть+a
měnit+na+4	менять+в+l
zaplatit+3	заплатить+за+a
odmítat+4	отвергать+a
pocítit+4	почувствовать+a
vysadit+z+2	высадить+с+i
napovídat+3	подсказывать+d
chytit+7	охватить+i
pochybovat+o+6	сомневаться+в+l
oddělit+4	отделить+от+g
vynahradit+4	возместить+a
zrušit+4	отменить+a
předávat+4	передавать+a
zakázat+3	запретить+d
zachovávat+v+6	хранить+в+l
zavádět+4	вводить+a
znít+7	звучать+для+g
podávat+3	подавать+d
řezat+4	резать+a
žádat+po+6	требовать+от+g
zahrnout+4	включить+n
sbírat+na+4	собирать+на+a
vydělat+na+6	заработать+перед+i
vkročit+na+4	вступить+в+l
zastávat+2	занимать+g
umožňovat+4	делать+a
zahodit+4	выбросить+a
naslouchat+3	прислушиваться+к+d
snímat+4	снимать+a
ochladit+4	охладить+a
zdůraznit+3	подчеркнуть+a
nést+4	нести+a
cestovat+na+4	ездить+на+l
uplatnit+4	заявить+во+a
zkazit+4	испортить+a
změnit+na+6	изменить+в+l
projet+7	проехать+a
předpovědět+4	предсказать+a
točit+3	крутить+i
přizpůsobit+3	приспособить+к+d
usazovat+4	усаживать+a
napadat+2	нападать+на+a
vymezit+7	ограничить+i
mýt+4	мыть+a
vést+s+7	идти+под+a
využívat+na+4	использовать+для+g
kolísat+na+4	колебаться+от+g
sejít+4	сдать+за+a
podkopat+4	подорвать+a
splynout+do+2	слиться+с+i
zabíjet+4	убивать+g
oslabovat+4	ослаблять+a
rozebrat+4	разобрать+a
soudit+s+7	судить+о+l
zlobit+na+4	сердить+на+a
povolovat+4	разрешать+a
popisovat+7	описывать+g
pokrýt+4	покрыть+i
přestoupit+4	перейти+в+a
oženit+s+7	женить+на+l
odjet+po+6	уехать+с+i
polykat+4	глотать+n
zavolat+4	позвонить+в+a
volit+mezi+7	выбирать+между+i
vyzbrojit+4	вооружить+a
použít+2	использовать+для+g
připouštět+4	допускать+g
zamáčknout+4	смять+a
upozorňovat+7	указывать+на+a
strhat+z+2	сорвать+с+g
lomcovat+7	трясти+a
přilákat+7	привлечь+g
postavit+3	поставить+перед+i
vrhat+4	бросать+a
otevřít+7	открыть+i
hospodařit+7	хозяйничать+i
projevit+4	проявить+a
nosit+k+3	носить+у+g
vystřihnout+4	вырезать+из+g
posunovat+4	двигать+a
přebírat+4	принимать+на+a
tlačit+na+4	давить+на+a
odsoudit+4	осудить+a
narazit+4	наткнуться+на+a
mířit+k+3	направляться+к+d
couvat+před+7	отступать+перед+i
přeletět+4	перелететь+через+a
namířit+k+3	направить+на+a
ohřívat+4	греть+под+i
zasvětit+3	посвятить+d
zkrátit+4	сократить+a
utíkat+před+7	спасаться+от+g
zastavovat+4	задерживать+a
slupnout+4	слопать+по+d
vyměňovat+s+7	менять+на+a
hovořit+s+7	говорить+с+i
vyrobit+z+2	изготовить+из+g
těžit+4	разрабатывать+g
vyrůst+o+4	вырасти+на+a
uhradit+4	покрыть+a
napodobovat+4	подражать+d
tvořit+4	составлять+a
dosáhnout+v+6	достичь+в+l
zapojovat+4	вовлекать+g
dodávat+4	придавать+a
užívat+4	принимать+a
hýbat+7	ворочать+i
vyčkávat+2	ждать+за+i
bránit+3	мешать+d
odnést+k+3	отнести+в+a
odnaučit+4	отучить+от+g
vzrůst+o+4	возрасти+на+l
dorazit+na+6	добраться+до+l
nechat+4	оставить+a
natočit+3	повернуть+к+d
posilovat+4	подкреплять+n
pokládat+3	укладывать+к+d
vypít+4	выпить+a
hodit+7	запустить+в+a
bývat+2	бывать+в+l
využívat+k+3	использовать+для+g
větrat+4	проветривать+a
minimalizovat+4	минимизировать+a
vyhlásit+3	объявить+о+l
skládat+4	сдавать+a
zapojit+4	вовлечь+в+a
zůstávat+z+2	оставаться+под+i
přiblížit+4	приблизить+a
jít+proti+3	пойти+против+g
klást+7	прокладывать+в+l
věřit+o+6	верить+в+a
zatarasit+4	загородить+a
vyprávět+o+6	рассказывать+о+l
oslabit+7	ослабить+i
chystat+3	готовить+на+a
disponovat+7	обладать+i
verbovat+4	вербовать+g
kupovat+4	покупать+a
rozdělit+mezi+4	поделить+между+i
snít+4	мечтать+о+l
chtít+po+6	требовать+от+g
oddálit+4	оттянуть+a
plout+na+4	идти+от+g
vyslat+na+4	направить+в+a
uspíšit+4	ускорить+a
modernizovat+4	модернизировать+a
vyměňovat+za+4	обменивать+на+a
ukázat+na+6	показать+на+a
akceptovat+4	принять+a
vyrovnat+4	выровнять+при+l
distribuovat+4	распространять+a
odevzdávat+4	передавать+от+g
vyvážit+7	уравновесить+i
vézt+4	везти+a
vypracovat+z+2	составить+на+a
rozpoznat+4	распознать+a
vybrat+3	выбрать+для+g
přihodit+4	подкинуть+на+a
uvrhnout+4	привести+a
řídit+4	управлять+i
financovat+4	финансировать+a
mrknout+na+4	глянуть+на+a
nechávat+7	оставлять+за+i
utrácet+4	тратить+a
povědět+o+6	рассказать+о+l
varovat+před+7	предупреждать+об+l
střežit+4	охранять+a
kázat+o+6	проповедовать+из+g
změřit+4	измерить+у+g
odvést+od+2	свести+на+a
zaplavit+7	залить+i
stavět+na+6	строить+на+l
odlétat+4	улетать+a
spojovat+s+7	связывать+с+i
ukládat+4	вкладывать+a
dopravit+4	доставить+a
vraždit+4	убивать+g
dávat+7	давать+g
mařit+4	препятствовать+d
oddalovat+4	откладывать+a
naplňovat+7	наполнять+i
ukazovat+7	указывать+на+a
požadovat+4	требовать+g
obhajovat+proti+3	защищать+в+l
upouštět+od+2	отходить+от+g
vyčkávat+s+7	ждать+за+i
ranit+7	ранить+в+a
žít+7	жить+с+i
stisknout+4	нажать+на+a
udržet+4	сохранить+a
odvážet+4	увозить+за+a
spadnout+z+2	упасть+с+g
kývat+7	кивать+i
dohodnout+s+7	договориться+с+i
skončit+4	закончиться+с+i
přát+3	желать+d
spáchat+4	совершить+a
dojmout+4	растрогать+g
tisknout+4	прижимать+к+d
odejít+k+3	отойти+к+d
rozbít+o+4	разбить+о+a
znepokojit+7	озаботить+i
namířit+na+4	прицелиться+в+l
říkat+3	говорить+d
povědět+4	рассказать+о+l
zabalit+7	уложить+в+a
upoutat+na+4	привлечь+к+d
naléhat+na+4	настаивать+на+l
zvednout+z+2	поднять+с+g
soupeřit+s+7	соперничать+с+i
péci+4	печь+a
najímat+3	нанимать+для+g
odepsat+4	списать+a
houpat+na+6	качаться+на+l
zanést+4	внести+в+a
obhajovat+4	защищать+a
prozradit+4	выдать+g
léčit+7	лечить+i
znázorňovat+4	изображать+a
omlouvat+4	оправдывать+g
vycházet+na+4	выходить+на+a
přát+od+2	желать+в+l
ochutnat+2	попробовать+на+a
předepisovat+4	предписывать+a
přehodit+přes+4	накинуть+на+a
soudit+o+6	судить+о+l
hvízdat+na+4	свистеть+в+a
deportovat+4	выслать+из+g
oznámit+4	объявить+о+l
utéci+z+2	сбежать+с+g
odradit+4	отбить+у+g
děsit+4	пугать+g
mít+3	иметь+по+d
zformulovat+4	сформулировать+a
skládat+7	укладывать+в+a
skončit+s+7	кончить+на+a
dostat+na+4	получить+по+d
vykazovat+4	показывать+a
ztrácet+4	терять+a
jít+k+3	пойти+к+d
připomenout+4	напомнить+n
oloupit+4	отнять+у+g
pít+4	пить+a
zůstat+na+4	остаться+на+l
vybudovat+na+6	создать+с+g
odejít+z+2	уйти+из+g
umlčet+4	заглушить+a
bojovat+4	бороться+за+a
vzbuzovat+7	возбуждать+в+l
oživit+4	оживить+a
stabilizovat+4	стабилизировать+a
přivézt+4	привезти+a
popírat+4	отрицать+n
stvořit+z+2	создать+из+g
psát+4	писать+a
mrknout+7	моргнуть+i
otvírat+4	открывать+a
nalévat+3	наливать+d
zůstávat+za+7	оставаться+по+a
získat+7	получить+в+l
dát+za+4	дать+за+a
přivítat+s+7	встретить+в+n
získávat+4	получать+a
získávat+od+2	получать+от+g
obviňovat+z+2	обвинять+в+l
přidat+k+3	добавить+к+d
probíhat+7	идти+о+l
rozdat+3	раздать+d
považovat+2	принимать+во+a
snít+3	мечтать+о+l
spolupracovat+na+6	сотрудничать+в+l
postoupit+4	передать+a
položit+na+4	положить+на+a
vylomit+4	взломать+a
oznámit+na+4	объявить+о+l
nabídnout+na+4	предложить+для+g
splést+4	перепутать+n
pálit+z+2	палить+из+l
vyhodit+7	выгнать+из+g
vyzvat+k+3	призвать+к+d
podepsat+4	подписать+a
doběhnout+k+3	добежать+до+g
sedět+3	сидеть+на+l
hostit+7	угощать+i
přejít+4	перейти+на+a
chytat+2	ловить+a
stát+na+6	стоять+на+l
zkoušet+4	пробовать+на+l
svádět+s+7	сваливать+на+a
opravit+4	починить+a
zamávat+3	помахать+d
zpravit+o+6	известить+об+l
dát+pro+4	велеть+из+g
zapůsobit+7	подействовать+i
držet+na+4	держаться+за+a
dohodnout+3	договориться+об+l
čerpat+2	черпать+g
věřit+na+4	верить+в+a
klepnout+7	стукнуть+i
ušetřit+4	избавить+от+g
myslet+7	думать+о+l
pohupovat+7	покачивать+i
směřovat+4	направляться+на+a
odejít+s+7	уйти+с+i
táhnout+7	идти+по+l
zkrášlit+4	украсить+n
přikázat+3	приказать+d
zdědit+4	унаследовать+a
vyhledat+4	найти+a
zabraňovat+3	мешать+d
sehnat+4	раздобыть+a
vykročit+k+3	шагнуть+к+d
pochovávat+4	хоронить+g
stanovit+4	определить+a
odpovídat+4	отвечать+на+a
redukovat+4	приводить+к+d
potkat+s+7	встретить+в+l
odsouhlasit+4	принять+на+l
svěřit+4	доверить+a
svírat+3	сжимать+a
přidělit+4	прикрепить+к+d
mířit+na+4	направлять+на+a
tajit+4	прятать+a
dávat+v+6	дарить+в+a
dodat+2	прибавить+перед+i
zvolit+4	выбрать+a
pomáhat+v+6	помогать+в+l
odvolat+z+2	снять+с+g
fasovat+4	получать+a
vyrobit+4	сделать+a
zaklepat+4	постучать+в+a
pomáhat+4	помогать+a
znamenat+4	означать+a
vrátit+do+2	вернуть+в+a
odkládat+4	откладывать+a
vyprávět+4	рассказывать+a
hrozit+7	угрожать+i
vnímat+4	воспринимать+a
propálit+4	сжечь+a
zahnout+na+4	свернуть+на+a
kreslit+4	рисовать+на+l
jmenovat+7	назначить+i
navrhnout+za+4	представить+к+l
docílit+4	достигнуть+g
následovat+2	последовать+за+i
nakládat+s+7	обращаться+с+i
srovnat+do+2	сравнить+с+g
pocházet+z+2	происходить+из+g
zavánět+7	отдавать+i
bojovat+s+7	бороться+с+i
vkládat+do+2	возлагать+на+a
používat+k+3	использовать+в+l
vynaložit+na+4	потратить+на+a
vydat+4	выпустить+a
znát+s+7	знать+о+l
pustit+do+2	впустить+в+a
zvýšit+z+2	поднять+с+l
vylít+4	вылить+из+g
odcházet+k+3	уходить+от+g
připojit+4	добавить+a
spasit+4	спасти+a
sypat+4	посыпать+a
uveřejnit+4	опубликовать+a
roznášet+4	разносить+a
snášet+pro+4	выдерживать+ради+g
myslit+7	думать+о+l
rozmluvit+3	отговорить+g
předčit+4	превзойти+n
vyšetřovat+4	расследовать+n
kývnout+na+4	кивнуть+на+a
zamířit+4	направиться+к+d
směňovat+4	обменивать+на+a
proměnit+na+4	превратить+в+a
podat+3	подать+d
odporovat+3	противоречить+d
nechat+na+4	оставить+на+l
zahrnovat+4	включать+в+a
naložit+s+7	погрузить+в+a
vynutit+7	добиться+при+l
vydělávat+na+4	зарабатывать+на+a
rozmlouvat+s+7	разговаривать+с+i
spojit+4	связать+a
zopakovat+4	повторить+a
využít+pro+4	использовать+для+g
zostřit+4	усилить+n
stát+při+6	стоять+на+l
urychlit+4	ускорить+a
pojistit+proti+3	застраховать+от+g
rámovat+4	обрамлять+a
poslat+na+4	послать+на+a
obdařit+7	наделить+i
změnit+na+4	изменить+на+a
přinutit+4	заставить+a
přeměnit+4	преобразовать+a
psát+na+4	писать+на+a
oslovovat+4	обращаться+к+d
zvyknout+na+4	привыкнуть+к+d
doprovodit+na+4	проводить+на+l
zpívat+3	петь+по+d
spolknout+4	проглотить+a
odnést+za+4	вынести+за+a
pomoci+při+6	помочь+в+l
spět+k+3	идти+к+d
zbít+4	избить+a
zesílit+4	усилить+a
soustředit+na+4	сосредоточить+на+l
svěřovat+4	поручать+n
předcházet+3	предшествовать+d
ukázat+4	указать+на+a
znásilňovat+4	насиловать+a
zaplňovat+4	заполнять+a
zlobit+4	сердить+на+a
mrkat+7	моргать+i
bojovat+proti+3	бороться+с+i
odjíždět+7	выезжать+из+g
válčit+s+7	воевать+с+i
vstoupit+do+2	войти+в+a
bít+4	биться+за+a
uvést+na+4	привести+к+d
obětovat+pro+4	пожертвовать+ради+g
předvídat+4	предвидеть+a
obracet+v+6	обращать+к+d
vidět+v+6	видеть+в+l
vznikat+3	возникать+между+i
ubíhat+4	проходить+a
nést+3	нести+в+l
zemřít+na+4	умереть+от+g
zajistit+3	обеспечить+g
prověřovat+4	проверять+a
připravovat+3	готовить+n
nabrat+7	набрать+в+l
schovat+4	спрятать+a
zaplavovat+4	заливать+a
vyplnit+7	наполнить+i
odhodit+4	отбросить+a
konkurovat+s+7	конкурировать+с+i
pouštět+2	выпускать+из+g
věřit+3	верить+d
vézt+na+6	везти+в+l
ovládat+4	управлять+i
napojit+4	напоить+g
odcházet+z+2	уходить+из+g
topit+7	топить+i
stlačit+4	нажать+a
vázat+z+2	связывать+с+i
odsuzovat+za+4	осуждать+за+a
snížit+na+4	сократить+до+g
narovnat+4	разогнуть+a
měnit+na+6	менять+в+l
vsunout+na+4	всунуть+в+a
ucítit+4	почувствовать+a
zamezit+3	предотвратить+a
připsat+na+4	приписать+к+d
třást+7	встряхивать+a
zastavit+k+3	остановиться+возле+g
přistihnout+při+6	застигнуть+на+l
prohloubit+4	углубить+a
mluvit+do+2	говорить+в+a
hrát+4	играть+в+a
dovést+k+3	привести+к+d
odnést+7	отнести+в+a
soupeřit+o+4	соперничать+за+a
vylézt+3	влезть+на+a
vypisovat+4	выписывать+a
uhnout+7	отклониться+в+a
užít+pro+4	использовать+для+g
čekat+3	ждать+d
vydělat+7	заработать+i
vyčerpat+4	исчерпать+a
vyžadovat+po+6	требовать+от+g
zkontrolovat+4	проверить+a
udat+4	сообщить+a
přinést+3	принести+d
kalit+4	портить+g
zanést+na+4	внести+в+a
vyvést+z+2	вывести+из+g
snížit+z+2	сократить+с+l
sestavit+z+2	составить+из+g
vyvinout+4	разработать+a
ukládat+na+4	укладывать+в+l
uložit+4	уложить+на+a
stíhat+4	преследовать+g
používat+2	пользоваться+i
odměnit+4	вознаградить+g
přivést+3	привести+к+d
vykopat+4	вырыть+на+l
volat+k+3	звать+к+d
šetřit+7	экономить+на+l
přivyknout+3	привыкнуть+к+d
vyčkávat+4	ждать+за+i
upoutávat+4	привлекать+в+l
pohladit+4	погладить+a
poděkovat+za+4	поблагодарить+за+a
utáhnout+4	затянуть+a
hovořit+o+6	говорить+о+l
stoupat+k+3	подниматься+к+d
vjet+7	въехать+i
ozdobit+7	украсить+i
oloupit+o+4	отнять+у+g
vyřídit+3	передать+d
najít+4	найти+a
vyúčtovat+4	рассчитаться+с+i
postavit+na+6	построить+на+l
stát+za+7	стоить+за+i
skrýt+před+7	скрыть+от+l
prorazit+4	проломить+a
odvolat+4	отстранить+от+g
dohnat+4	наверстать+a
požívat+4	пользоваться+i
příslušet+3	принадлежать+по+d
nominovat+4	назначать+n
vyučovat+4	преподавать+a
utvrdit+4	укрепить+a
vyvádět+z+2	выводить+из+g
chodit+k+3	ходить+к+d
podtrhnout+4	подчеркнуть+n
zaslechnout+4	услышать+a
odletět+k+3	вылететь+на+a
zastiňovat+4	заслонять+от+g
ubezpečit+4	уверить+g
chytit+do+2	поймать+в+a
vonět+po+6	пахнуть+от+g
odpírat+3	отказывать+в+l
pokládat+4	считать+i
udělat+na+6	сделать+с+i
brát+k+3	брать+на+a
provázet+7	провожать+i
napsat+na+4	написать+на+l
nadhodit+4	подбросить+в+l
zaregistrovat+4	зарегистрировать+a
holit+4	брить+a
odlišit+4	отличить+от+g
splývat+s+7	сливаться+с+i
povolat+4	вызвать+к+d
přehodit+na+4	накинуть+на+a
vyhradit+4	отвести+a
přesunout+na+4	переместить+на+a
narazit+3	столкнуться+с+i
nakousnout+4	начать+a
zmodernizovat+4	модернизировать+n
přidat+2	прибавить+n
zasvěcovat+4	посвящать+a
vypracovat+4	разработать+a
ignorovat+4	игнорировать+a
postavit+4	поставить+a
zasvětit+4	посвятить+a
tlouci+4	биться+a
vykládat+o+6	говорить+о+l
uchvátit+4	увлечь+за+i
vzít+k+3	взять+с+i
odjíždět+po+6	отходить+спустя+a
předvést+3	показать+d
napadnout+4	напасть+на+l
pojmenovat+7	назвать+i
přísahat+4	клясться+i
ošetřovat+4	ухаживать+i
vyrábět+4	производить+a
vykřikovat+4	выкрикивать+a
vyjmout+4	вынуть+из+g
přidržovat+7	придерживать+i
topit+4	топить+в+n
zvrátit+4	повернуть+a
dorazit+4	добраться+до+g
nastavit+4	подставить+a
propagovat+4	пропагандировать+a
rodit+z+2	рожать+для+g
odvětit+7	ответить+n
slučovat+4	сочетать+в+l
přerušit+7	прервать+i
sahat+po+6	тянуться+к+d
trávit+4	коротать+a
běžet+4	бежать+по+d
pohánět+7	побуждать+i
přizpůsobit+4	адаптировать+n
vytrhovat+z+2	вырывать+из+g
fandit+3	болеть+за+a
dospět+k+3	прийти+к+d
ospravedlňovat+4	оправдывать+a
vychutnávat+4	наслаждаться+i
odvézt+k+3	отвезти+в+a
dospět+v+4	прийти+к+d
zlikvidovat+7	ликвидировать+за+a
prolomit+4	сломать+a
vypovědět+o+6	отказаться+от+g
zbít+7	избить+n
pohnout+4	пошевелить+i
analyzovat+4	анализировать+a
tkvít+v+6	заключаться+в+l
šuškat+4	шептаться+на+l
uvolnit+4	освободить+a
dostávat+na+4	получать+за+a
přeměnit+na+4	превратить+из+g
ocenit+v+6	оценить+после+g
pozměňovat+4	менять+a
ustoupit+v+6	отступиться+в+a
chystat+4	готовить+на+a
šeptat+3	шептать+d
donést+3	принести+к+d
natahovat+3	протягивать+d
vyhodnotit+4	оценить+a
prokazovat+4	оказывать+a
rozumět+4	понимать+g
procvičovat+4	упражняться+на+l
vytrhnout+4	вырвать+у+g
klesnout+7	упасть+с+g
odesílat+na+4	посылать+в+a
šlápnout+4	наступить+на+a
vypočítat+4	подсчитать+a
uchránit+4	защитить+a
přilepit+k+3	приклеить+к+l
zkusit+4	попробовать+на+l
přitlačit+4	нажать+a
rozpoutávat+4	разжигать+n
předávat+3	передавать+d
přivodit+4	вызвать+n
roztahovat+4	растягивать+g
rozebírat+4	разбирать+g
nanášet+4	наносить+на+a
uniknout+3	избежать+g
spustit+k+3	спустить+на+a
předat+4	передать+a
uvolňovat+4	освобождать+a
potrestat+4	наказать+g
zmrazit+4	заморозить+a
vsouvat+4	вставлять+через+a
sdělovat+4	сообщать+о+l
obžalovat+4	обвинить+в+l
zodpovídat+3	отвечать+перед+i
šplhat+na+4	карабкаться+на+a
nabývat+2	приобретать+a
připadat+na+4	приходиться+на+a
vysvětlit+7	объяснить+i
vymezit+4	определить+n
držet+3	держаться+за+a
navštívit+4	посетить+a
odjíždět+4	уезжать+a
redukovat+na+4	приводить+к+d
zakrývat+7	закрывать+i
poplést+4	перепутать+a
zpívat+o+6	петь+о+l
krýt+4	прикрывать+g
přihodit+na+4	подкинуть+на+a
vydávat+4	тратить+на+a
rozrušit+4	взволновать+до+g
táhnout+4	тащить+за+i
zanechávat+4	оставлять+за+i
píchnout+7	ткнуть+i
srovnat+4	сравнить+g
požádat+po+6	попросить+у+g
vznést+4	поднять+a
nastartovat+4	завести+a
lákat+7	манить+i
vztahovat+na+4	протягивать+к+d
klást+za+4	возлагать+на+a
objasnit+4	объяснить+n
docházet+3	происходить+в+a
seznámit+s+7	познакомить+с+i
uvalit+na+4	возложить+на+a
podporovat+v+6	поддерживать+в+l
potvrdit+7	подтвердить+в+l
přát+2	желать+a
připadat+7	казаться+до+g
vystoupit+s+7	выступить+на+l
navrátit+4	вернуть+к+d
přerušovat+4	прерывать+g
chystat+na+4	готовить+на+a
zůstávat+při+6	оставаться+на+l
ubíjet+4	убивать+a
hodit+k+3	швырнуть+к+l
potkávat+4	встречать+на+l
táhnout+k+3	тянуть+к+d
zdemolovat+4	разгромить+a
zvyšovat+7	повышать+при+l
zamumlat+4	пробормотать+a
ulehčit+4	облегчить+a
uhodit+4	накинуться+на+a
srovnávat+7	сравнивать+с+i
odloučit+4	отделить+a
otočit+4	повернуть+a
přemluvit+k+3	уговорить+на+a
zakoupit+4	купить+для+g
měřit+7	измерять+по+d
balit+4	упаковывать+g
vypustit+4	выпустить+из+g
bránit+v+6	стоять+у+g
zdvihat+4	поднимать+g
zvonit+4	звонить+в+a
spálit+4	сжечь+a
hlídat+4	следить+за+a
zavolat+na+4	позвонить+в+a
uvidět+4	увидеть+a
pískat+4	играть+на+l
nakládat+4	грузить+на+a
vyhrávat+4	играть+a
odsoudit+za+4	осудить+за+a
posílit+4	укрепить+a
zachovávat+4	сохранять+a
objevovat+4	открывать+a
sestavovat+4	составлять+a
symbolizovat+4	символизировать+a
protáhnout+4	протянуть+a
uznat+4	признать+a
dodávat+2	поставлять+в+a
dodávat+3	придавать+g
mít+před+7	думать+о+l
opakovat+po+6	повторить+за+i
vypovědět+4	отказаться+от+g
pískat+na+4	играть+на+l
přemoci+v+6	победить+в+l
usedat+k+3	усаживаться+за+a
zlomit+4	сломать+a
jezdit+s+7	ездить+с+i
kývat+na+4	кивать+на+a
navazovat+4	устанавливать+a
využít+na+4	использовать+для+g
odloučit+od+2	отделить+от+g
zfalšovat+4	подделать+a
dohlížet+na+4	следить+за+i
plavat+v+6	плавать+в+l
dohodnout+na+6	договориться+о+l
přejít+k+3	перейти+к+d
natočit+4	записать+на+a
začít+4	начать+a
přijmout+do+2	принять+в+a
vykonávat+4	отправлять+a
dodat+do+2	прибавить+перед+i
bránit+4	защищать+a
využívat+2	использовать+a
protestovat+7	возражать+против+g
posoudit+4	оценить+a
plánovat+4	планировать+a
spekulovat+o+6	спекулировать+по+d
vyústit+v+4	вылиться+в+a
odpovídat+za+4	отвечать+за+a
zaměřit+na+4	сосредоточить+на+l
vytáhnout+k+3	вытащить+из+g
vytvářet+z+2	создавать+из+g
činit+z+2	делать+для+g
zneužít+2	злоупотребить+i
slyšet+z+2	слышать+от+g
sdílet+s+7	делить+с+i
integrovat+do+2	интегрировать+в+a
zapálit+7	зажечь+i
radit+3	советовать+d
připomínat+4	напоминать+a
chápat+2	понимать+g
brát+s+7	брать+с+i
stoupat+z+2	подниматься+в+l
dovést+3	довести+до+g
prohlásit+7	заявить+i
převádět+4	переводить+n
dát+do+2	вложить+в+a
přijet+na+6	приехать+на+l
přežívat+4	выживать+в+l
mlátit+7	бить+i
pochválit+4	похвалить+за+a
přenést+na+4	перенести+на+a
splnit+4	выполнить+a
nasměrovat+4	направить+на+a
dát+4	дать+a
podnikat+v+6	предпринимать+до+g
vyděsit+4	испугать+g
mnout+4	тереть+a
vysadit+4	посадить+на+a
nalít+4	налить+g
uklízet+4	убирать+a
obejít+s+7	обойти+вокруг+g
zpřísnit+4	усилить+a
nutit+7	заставлять+n
odpouštět+3	прощать+g
importovat+4	импортировать+a
dávat+o+6	давать+о+l
fouknout+na+4	подуть+на+a
trpět+na+4	страдать+в+a
vydělit+4	выделить+a
působit+7	действовать+под+i
vytrhávat+4	вырывать+из+g
žít+s+7	жить+с+i
zasílat+4	посылать+a
degradovat+z+2	понизить+с+g
snít+o+6	мечтать+о+l
doufat+v+4	надеяться+на+a
připisovat+3	приписывать+d
připisovat+4	приписывать+a
doufat+v+4	надеяться+на+a
připisovat+3	приписывать+d
připisovat+4	приписывать+a
doufat+v+4	надеяться+на+a
připisovat+3	приписывать+d
připisovat+4	приписывать+a
